上	Above
下	Below
大	Big
工	Construction
八	Eight
入	Enter
山	Mountain
口	Mouth
九	Nine
一	One
人	Person
力	Power
川	River
七	Seven
十	Ten
三	Three
二	Two
女	Woman
又	Again
玉	Ball
本	Book
子	Child
丸	Circle
正	Correct
土	Dirt
犬	Dog
夕	Evening
出	Exit
目	Eye
了	Finish
火	Fire
五	Five
四	Four
才	Genius
手	Hand
天	Heaven
王	King
左	Left
中	Middle
月	Moon
々	Repeater
田	Rice Paddy
右	Right
六	Six
小	Small
立	Stand
丁	Street
日	Sun
刀	Sword
千	Thousand
木	Tree
水	Water
白	White
文	Writing
円	Yen
矢	Arrow
市	City
牛	Cow
切	Cut
方	Direction
戸	Door
太	Fat
父	Father
少	Few
友	Friend
毛	Fur
半	Half
心	Heart
内	Inside
生	Life
台	Machine
母	Mother
午	Noon
北	North
今	Now
古	Old
元	Origin
外	Outside
分	Part
公	Public
引	Pull
止	Stop
用	Task
万	Ten Thousand
広	Wide
冬	Winter
竹	Bamboo
車	Car
央	Center
写	Copy
仕	Doing
耳	Ear
早	Early
気	Energy
平	Flat
花	Flower
足	Foot
打	Hit
百	Hundred
氷	Ice
虫	Insect
字	Letter
男	Man
主	Master
名	Name
不	Not
号	Number
他	Other
去	Past
皿	Plate
先	Previous
赤	Red
休	Rest
申	Say Humbly
見	See
貝	Shellfish
石	Stone
代	Substitute
礼	Thanks
糸	Thread
町	Town
宝	Treasure
村	Village
世	World
年	Year
角	Angle
斤	Axe
青	Blue
体	Body
色	Color
来	Come
社	Company
当	Correct
図	Diagram
毎	Every
羽	Feather
林	Forest
行	Go
金	Gold
草	Grass
里	Hometown
作	Make
多	Many
肉	Meat
会	Meet
交	Mix
近	Near
兄	Older Brother
雨	Rain
米	Rice
走	Run
同	Same
言	Say
自	Self
形	Shape
皮	Skin
空	Sky
音	Sound
学	Study
光	Sunlight
考	Think
回	Times
谷	Valley
声	Voice
西	West
何	What
麦	Wheat
弟	Younger Brother
全	All
後	Behind
血	Blood
両	Both
明	Bright
京	Capital
化	Change
国	Country
科	Course
死	Death
亡	Death
画	Drawing
地	Earth
東	East
食	Eat
直	Fix
前	Front
有	Have
私	I
知	Know
活	Lively
長	Long
曲	Music
首	Neck
次	Next
夜	Night
姉	Older Sister
点	Point
安	Relax
室	Room
海	Sea
羊	Sheep
店	Shop
南	South
星	Star
州	State
茶	Tea
思	Think
歩	Walk
向	Yonder
妹	Younger Sister
辺	Area
付	Attach
札	Bill
鳥	Bird
黒	Black
船	Boat
必	Certain
末	End
氏	Family Name
失	Fault
魚	Fish
以	From
組	Group
家	House
欠	Lack
未	Not Yet
紙	Paper
通	Pass Through
民	Peoples
由	Reason
理	Reason
校	School
雪	Snow
強	Strong
夏	Summer
高	Tall
教	Teach
時	Time
弱	Weak
週	Week
風	Wind
記	Write Down
黄	Yellow
答	Answer
反	Anti
君	Buddy
局	Bureau
買	Buy
雲	Cloud
楽	Comfort
数	Count
決	Decide
絵	Drawing
住	Dwelling
電	Electricity
森	Forest
助	Help
馬	Horse
間	Interval
場	Location
医	Medicine
朝	Morning
番	Number In A Series
所	Place
池	Pond
究	Research
道	Road
役	Service
研	Sharpen
身	Somebody
者	Someone
支	Support
話	Talk
投	Throw
対	Versus
受	Accept
事	Action
美	Beauty
予	Beforehand
服	Clothes
度	Degrees
発	Departure
定	Determine
談	Discuss
表	Express
客	Guest
重	Heavy
持	Hold
負	Lose
相	Mutual
要	Need
新	New
部	Part
和	Peace
県	Prefecture
保	Preserve
返	Return
乗	Ride
屋	Roof
売	Sell
送	Send
苦	Suffering
泳	Swim
仮	Temporary
験	Test
物	Thing
具	Tool
実	Truth
試	Try
使	Use
勝	Win
界	World
進	Advance
酒	Alcohol
始	Begin
業	Business
算	Calculate
運	Carry
漢	Chinese
鳴	Chirp
集	Collect
配	Distribute
飲	Drink
終	End
顔	Face
落	Fall
農	Farming
速	Fast
頭	Head
聞	Hear
院	Institution
調	Investigate
鉄	Iron
語	Language
葉	Leaf
習	Learn
軽	Lightweight
線	Line
最	Most
開	Open
親	Parent
読	Read
求	Request
転	Revolve
路	Road
病	Sick
横	Side
歌	Song
起	Wake Up
功	Achievement
成	Become
岸	Coast
競	Compete
争	Conflict
便	Convenience
老	Elderly
命	Fate
指	Finger
初	First
味	Flavor
追	Follow
神	God
良	Good
意	Idea
労	Labor
級	Level
好	Like
昔	Long Ago
低	Low
育	Nurture
令	Orders
拾	Pick Up
注	Pour
利	Profit
位	Rank
仲	Relationship
放	Release
秒	Second
別	Separate
特	Special
共	Together
努	Toil
伝	Transmit
戦	War
波	Wave
洋	Western Style
働	Work
悪	Bad
息	Breath
章	Chapter
登	Climb
寒	Cold
深	Deep
倍	Double
勉	Exertion
消	Extinguish
祭	Festival
野	Field
階	Floor
庭	Garden
港	Harbor
暑	Hot
湯	Hot Water
僕	I
島	Island
童	Juvenile
員	Member
商	Merchandise
都	Metropolis
動	Move
第	Ordinal Number Prefix
期	Period Of Time
植	Plant
根	Root
短	Short
球	Sphere
泉	Spring
流	Stream
合	Suit
陽	Sunshine
歯	Tooth
族	Tribe
旅	Trip
待	Wait
温	Warm
着	Wear
皆	All
謝	Apologize
整	Arrange
橋	Bridge
選	Choose
想	Concept
器	Container
暗	Dark
疑	Doubt
料	Fee
感	Feeling
情	Feeling
様	Formal Name Title
養	Foster
緑	Green
熱	Heat
億	Hundred Million
殺	Kill
宿	Lodge
福	Luck
鏡	Mirror
然	Nature
詩	Poem
練	Practice
賞	Prize
問	Problem
館	Public Building
映	Reflect
願	Request
士	Samurai
課	Section
標	Signpost
銀	Silver
駅	Station
像	Statue
題	Topic
輪	Wheel
能	Ability
芸	Acting
術	Art
雰	Atmosphere
骨	Bone
束	Bundle
周	Circumference
協	Cooperation
例	Example
折	Fold
基	Foundation
性	Gender
妥	Gentle
卒	Graduate
固	Hard
望	Hope
材	Lumber
参	Participate
完	Perfect
松	Pine
約	Promise
残	Remainder
季	Seasons
技	Skill
格	Status
頑	Stubborn
囲	Surround
的	Target
念	Thought
希	Wish
紀	Account
軍	Army
秋	Autumn
信	Believe
岩	Boulder
仏	Buddha
建	Build
猫	Cat
変	Change
晴	Clear Up
築	Construct
勇	Courage
泣	Cry
司	Director
区	District
英	England
丈	Height
夫	Husband
飯	Meal
計	Measure
法	Method
晩	Night
昼	Noon
毒	Poison
昨	Previous
帰	Return
式	Ritual
列	Row
浅	Shallow
単	Simple
坂	Slope
春	Spring
寺	Temple
浴	Bathe
箱	Box
係	Connection
治	Cure
危	Dangerous
冒	Dare
留	Detain
弁	Dialect
証	Evidence
存	Exist
面	Face
遠	Far
園	Garden
門	Gates
府	Government
幸	Happiness
阪	Heights
急	Hurry
笑	Laugh
荷	Luggage
政	Politics
品	Product
守	Protect
辞	Quit
真	Reality
関	Related
険	Risky
典	Rule
専	Specialty
冗	Superfluous
取	Take
曜	Weekday
書	Write
是	Absolutely
結	Bind
底	Bottom
因	Cause
詳	Detailed
識	Discerning
劇	Drama
干	Dry
敗	Failure
渉	Ford
果	Fruit
官	Government
署	Government Office
察	Guess
堂	Hall
幻	Illusion
非	Injustice
愛	Love
薬	Medicine
覚	Memorize
鼻	Nose
無	Nothing
常	Normal
原	Original
栄	Prosper
喜	Rejoice
恋	Romance
悲	Sad
塩	Salt
席	Seat
側	Side
兵	Soldier
説	Theory
細	Thin
梅	Ume
虚	Void
警	Warn
告	Announce
達	Attain
焼	Bake
借	Borrow
弓	Bow
脳	Brain
飴	Candy
胸	Chest
喫	Consume
等	Equal
枚	Flat Objects Counter
忘	Forget
訓	Instruction
種	Kind
報	News
句	Paragraph
許	Permit
可	Possible
祈	Pray
僧	Priest
禁	Prohibit
静	Quiet
座	Sit
煙	Smoke
汽	Steam
叩	Strike
喉	Throat
類	Type
洗	Wash
禅	Zen
得	Acquire
加	Add
冊	Book Counter
履	Boots
忙	Busy
閥	Clique
布	Cloth
比	Compare
歴	Continuation
続	Continue
減	Decrease
易	Easy
絡	Entangle
笛	Flute
容	Form
団	Group
史	History
昆	Insect
徒	Junior
宙	Midair
混	Mix
善	Morally Good
順	Order
宇	Outer Space
詞	Part Of Speech
改	Renew
乱	Riot
節	Season
連	Take Along
舌	Tongue
暴	Violence
財	Wealth
若	Young
責	Blame
条	Clause
済	Come To An End
委	Committee
省	Conserve
制	Control
批	Criticism
断	Cut Off
任	Duty
素	Element
敵	Enemy
羨	Envy
設	Establish
評	Evaluate
検	Examine
岡	Hill
増	Increase
査	Inspect
判	Judge
審	Judge
件	Matter
際	Occasion
企	Plan
挙	Raise
認	Recognize
資	Resources
義	Righteousness
権	Rights
派	Sect
務	Task
税	Tax
解	Untie
総	Whole
援	Aid
態	Appearance
誕	Birth
状	Condition
賀	Congratulations
各	Each
費	Expense
姿	Figure
勢	Force
諦	Give Up
示	Indicate
寝	Lie Down
営	Manage
坊	Monk
罰	Penalty
策	Plan
案	Plan
提	Present
置	Put
域	Region
応	Respond
宮	Shinto Shrine
袖	Sleeve
吸	Suck
過	Surpass
領	Territory
脱	Undress
統	Unite
価	Value
値	Value
副	Vice
観	View
藤	Wisteria
呼	Call
崎	Cape
施	Carry Out
城	Castle
護	Defend
鬼	Demon
割	Divide
職	Employment
秀	Excel
俳	Haiku
停	Halt
宅	House
裁	Judge
律	Law
導	Lead
革	Leather
贅	Luxury
乳	Milk
収	Obtain
演	Perform
現	Present Time
備	Provide
則	Rule
規	Standard
準	Standard
張	Stretch
優	Superior
沢	Swamp
師	Teacher
幹	Tree Trunk
看	Watch Over
庁	Agency
額	Amount
腕	Arm
境	Boundary
燃	Burn
担	Carry
祝	Celebrate
届	Deliver
違	Different
差	Distinction
象	Elephant
展	Expand
層	Layer
視	Look At
環	Loop
製	Manufacture
述	Mention
武	Military
型	Model
狭	Narrow
管	Pipe
載	Publish
質	Quality
量	Quantity
販	Sell
供	Servant
肩	Shoulder
株	Stocks
触	Touch
輸	Transport
腰	Waist
慣	Accustomed
居	Alive
逮	Apprehend
票	Ballot
属	Belong
捉	Catch
捕	Catch
候	Climate
輩	Comrade
況	Condition
響	Echo
効	Effective
抜	Extract
鮮	Fresh
満	Full
与	Give
掛	Hang
隠	Hide
模	Imitation
含	Include
訟	Lawsuit
限	Limit
肥	Obese
豊	Plentiful
替	Replace
景	Scene
巻	Scroll
捜	Search
構	Set Up
影	Shadow
絞	Strangle
訴	Sue
補	Supplement
渡	Transit
接	Adjoin
再	Again
独	Alone
獣	Beast
菓	Cake
討	Chastise
故	Circumstance
較	Contrast
造	Create
創	Create
往	Depart
励	Encourage
激	Fierce
占	Fortune
障	Hinder
我	I
徴	Indication
授	Instruct
鉛	Lead
郵	Mail
針	Needle
従	Obey
豚	Pork
復	Restore
河	River
貯	Savings
印	Seal
振	Shake
刺	Stab
突	Stab
怪	Suspicious
汗	Sweat
筆	Writing Brush
怒	Angry
昇	Ascend
迷	Astray
招	Beckon
腹	Belly
睡	Drowsy
康	Ease
端	Edge
極	Extreme
郎	Guy
健	Healthy
誘	Invite
貸	Lend
惑	Misguided
痛	Pain
退	Retreat
途	Route
給	Salary
就	Settle In
靴	Shoes
眠	Sleep
暇	Spare Time
段	Steps
胃	Stomach
症	Symptom
濃	Thick
締	Tighten
迫	Urge
訪	Visit
織	Weave
悩	Worry
屈	Yield
攻	Aggression
撃	Attack
浜	Beach
綺	Beautiful
益	Benefit
児	Child
憲	Constitution
冷	Cool
処	Deal With
微	Delicate
修	Discipline
博	Exhibition
程	Extent
絶	Extinction
凍	Frozen
巨	Giant
稚	Immature
幼	Infancy
並	Line Up
麗	Lovely
奇	Odd
衆	Populace
潔	Pure
清	Pure
録	Record
逆	Reverse
移	Shift
精	Spirit
隊	Squad
庫	Storage
妙	Strange
券	Ticket
傘	Umbrella
婦	Wife
略	Abbreviation
積	Accumulate
添	Append
寄	Approach
宴	Banquet
板	Board
壊	Break
督	Coach
僚	Colleague
杯	Cup Of Liquid
娘	Daughter
診	Diagnose
乾	Dry
欧	Europe
恐	Fear
猛	Fierce
江	Inlet
韓	Korea
雄	Male
航	Navigation
監	Oversee
宗	Religion
請	Request
怖	Scary
索	Search
臣	Servant
催	Sponsor
街	Street
詰	Stuffed
緊	Tense
閣	The Cabinet
促	Urge
烈	Violent
帯	Belt
廊	Corridor
離	Detach
径	Diameter
融	Dissolve
均	Equal
除	Exclude
貨	Freight
孫	Grandchild
墓	Grave
幾	How Many
尋	Inquire
編	Knit
陸	Land
探	Look For
豪	Luxurious
鑑	Model
泥	Mud
巣	Nest
普	Normal
棒	Pole
粉	Powder
既	Previously
救	Rescue
似	Resemble
富	Rich
散	Scatter
華	Showy
嘆	Sigh
偵	Spy
驚	Surprised
掃	Sweep
菜	Vegetable
脈	Vein
徳	Virtue
倉	Warehouse
酸	Acid
賛	Agree
祖	Ancestor
銭	Coin
込	Crowded
衛	Defense
机	Desk
汚	Dirty
飼	Domesticate
複	Duplicate
染	Dye
卵	Egg
永	Eternity
績	Exploits
眼	Eyeball
液	Fluid
採	Gather
志	Intention
興	Interest
恩	Kindness
久	Long Time
党	Party
序	Preface
雑	Random
桜	Sakura
密	Secrecy
秘	Secret
厳	Strict
捨	Throw Away
訳	Translation
欲	Want
暖	Warm
迎	Welcome
傷	Wound
灰	Ashes
装	Attire
著	Author
裏	Backside
閉	Closed
垂	Dangle
漠	Desert
異	Differ
皇	Emperor
拡	Extend
暮	Livelihood
忠	Loyalty
肺	Lung
誌	Magazine
操	Manipulate
筋	Muscle
否	No
盛	Pile
宣	Proclaim
賃	Rent
敬	Respect
尊	Revered
熟	Ripen
噂	Rumor
砂	Sand
簡	Simplicity
蒸	Steam
蔵	Storehouse
糖	Sugar
納	Supply
諸	Various
窓	Window
豆	Beans
枝	Branch
揮	Brandish
刻	Carve
爪	Claw
承	Consent
幕	Curtain
紅	Deep Red
歓	Delight
降	Descend
奴	Dude
聖	Holy
推	Infer
臓	Internal Organs
損	Loss
磁	Magnet
誤	Mistake
源	Origin
芋	Potato
純	Pure
薦	Recommend
丼	Rice Bowl
腐	Rot
沿	Run Alongside
射	Shoot
縮	Shrink
隷	Slave
粋	Stylish
痩	Thin
吐	Throw Up
貴	Valuable
縦	Vertical
勤	Work
拝	Worship
熊	Bear
噌	Boisterous
彫	Carve
杉	Cedar
喋	Chat
銅	Copper
舎	Cottage
酔	Drunk
炎	Flame
彼	He
紹	Introduce
介	Jammed In
湖	Lake
講	Lecture
寿	Lifespan
測	Measure
互	Mutual
油	Oil
己	Oneself
払	Pay
鍋	Pot
獄	Prison
為	Sake
恥	Shame
遅	Slow
汁	Soup
醤	Soy Sauce
滞	Stagnate
剣	Sword
破	Tear
亀	Turtle
厄	Unlucky
酢	Vinegar
諾	Agreement
盟	Alliance
将	Commander
舞	Dance
債	Debt
伎	Deed
鹿	Deer
換	Exchange
牙	Fang
旧	Former
般	Generally
津	Haven
療	Heal
継	Inherit
遺	Leave Behind
維	Maintain
奈	Nara
核	Nucleus
廃	Obsolete
献	Offer
沖	Open Sea
摘	Pluck
及	Reach
依	Reliant
縄	Rope
鮭	Salmon
踏	Step
伸	Stretch
姓	Surname
甘	Sweet
貿	Trade
頼	Trust
超	Ultra
幅	Width
患	Afflicted
狙	Aim
陣	Army Base
塁	Base
弾	Bullet
葬	Burial
抗	Confront
崩	Crumble
遣	Dispatch
掲	Display
爆	Explode
眉	Eyebrows
恵	Favor
漁	Fishing
香	Fragrance
湾	Gulf
跳	Hop
抱	Hug
旬	In Season
聴	Listen
臨	Look To
兆	Omen
契	Pledge
刑	Punish
募	Recruit
償	Reparation
抵	Resist
戻	Return
昭	Shining
串	Skewer
闘	Struggle
執	Tenacious
跡	Traces
削	Whittle Down
伴	Accompany
齢	Age
宜	Best Regards
賂	Bribe
賄	Bribe
房	Cluster
慮	Consider
託	Consign
却	Contrary
需	Demand
致	Do
避	Dodge
描	Draw
刊	Edition
逃	Escape
扱	Handle
奥	Interior
併	Join
膝	Knee
傾	Lean
緩	Loose
奏	Play Music
娠	Pregnant
妊	Pregnant
贈	Presents
択	Select
還	Send Back
繰	Spin
抑	Suppress
懸	Suspend
称	Title
緒	Together
盤	Tray
控	Abstain
宛	Address
充	Allocate
渋	Bitter
岐	Branch Off
埋	Bury
鈴	Buzzer
埼	Cape
棋	Chess Piece
譲	Defer
雇	Employ
免	Excuse
群	Flock
枠	Frame
銃	Gun
仙	Hermit
邦	Home Country
御	Honorable
慎	Humility
躍	Leap
謙	Modesty
阜	Mound
片	One Sided
項	Paragraph
斐	Patterned
隆	Prosperity
圏	Range
勧	Recommend
拒	Refuse
稲	Rice Plant
奪	Rob
鋼	Steel
甲	Turtle Shell
壁	Wall
祉	Welfare
棄	Abandon
凄	Amazing
至	Attain
拠	Based On
蜂	Bee
儀	Ceremony
炭	Charcoal
衣	Clothes
潜	Conceal
偽	Fake
畑	Field
蛍	Firefly
拳	Fist
郷	Hometown
蜜	Honey
仁	Humanity
遜	Humble
侵	Invade
嘘	Lie
鉱	Mineral
喧	Noisy
伺	Pay Respects
徹	Penetrate
瀬	Rapids
嘩	Rowdy
墟	Ruins
酎	Sake
措	Set Aside
誠	Sincerity
虎	Tiger
艦	Warship
撤	Withdrawal
樹	Wood
包	Wrap
析	Analysis
弧	Arc
到	Arrival
軸	Axis
綱	Cable
挑	Challenge
焦	Char
掘	Dig
紛	Distract
範	Example
括	Fasten
床	Floor
握	Grip
枢	Hinge
揚	Hoist
潟	Lagoon
芝	Lawn
肝	Liver
喪	Mourning
網	Netting
克	Overcome
泊	Overnight
双	Pair
柄	Pattern
哲	Philosophy
斎	Purification
袋	Sack
揺	Shake
滑	Slippery
堅	Solid
暫	Temporarily
糾	Twist
荒	Wild
襲	Attack
沼	Bog
朗	Bright
摩	Chafe
趣	Charm
懲	Chastise
慰	Consolation
懇	Courteous
筒	Cylinder
滅	Destroy
距	Distance
籍	Enroll
露	Expose
炉	Furnace
柔	Gentle
擦	Grate
琴	Harp
垣	Hedge
即	Instant
威	Majesty
滋	Nourishing
牧	Pasture
泰	Peace
岳	Peak
旨	Point
刷	Printing
珍	Rare
封	Seal
斉	Simultaneous
沈	Sink
撲	Slap
裂	Split
潮	Tide
貢	Tribute
誰	Who
刃	Blade
缶	Can
砲	Cannon
笠	Conical Hat
竜	Dragon
拶	Draw Close
縁	Edge
忍	Endure
釣	Fishing
吉	Good Luck
粒	Grains
髪	Hair
丘	Hill
俺	I
斗	Ladle
寸	Measurement
桃	Peach
梨	Pear
姫	Princess
挨	Push Open
娯	Recreation
謎	Riddle
侍	Samurai
叱	Scold
棚	Shelf
叫	Shout
匹	Small Animal
辛	Spicy
芽	Sprout
嵐	Storm
涙	Teardrop
雷	Thunder
塔	Tower
朱	Vermillion
翼	Wing
頃	Approximate
菌	Bacteria
鐘	Bell
舟	Boat
嫁	Bride
暦	Calendar
曇	Cloudy
也	Considerably
塾	Cram School
呪	Curse
湿	Damp
稼	Earnings
疲	Exhausted
翔	Fly
賭	Gamble
霊	Ghost
溝	Gutter
狩	Hunt
脚	Leg
澄	Lucidity
塊	Lump
狂	Lunatic
嬢	Miss
裸	Naked
磨	Polish
陰	Shade
肌	Skin
魂	Soul
矛	Spear
眺	Stare
硬	Stiff
卓	Table
凶	Villain
滝	Waterfall
井	Well
墨	Black Ink
瞬	Blink
泡	Bubbles
穏	Calm
孔	Cavity
椅	Chair
菊	Chrysanthemum
涼	Cool
綿	Cotton
魔	Devil
寮	Dormitory
鳩	Dove
鈍	Dull
鍛	Forge
碁	Go
癖	Habit
穂	Head of Plant
吾	I
鍵	Key
盆	Lantern Festival
庄	Manor
猿	Monkey
棟	Pillar
誇	Pride
瞳	Pupil
寧	Rather
俵	Sack
幽	Secluded
架	Shelf
黙	Shut Up
斬	Slice
帝	Sovereign
租	Tariff
錬	Tempering
阻	Thwart
歳	Years Old
零	Zero
幣	Cash
箸	Chopsticks
瞭	Clear
崖	Cliff
炊	Cook
粧	Cosmetics
墜	Crash
欺	Deceit
滴	Drip
塀	Fence
霧	Fog
扇	Folding Fan
扉	Front Door
恨	Grudge
帽	Hat
憎	Hate
佐	Help
挿	Insert
伊	Italy
詐	Lie
如	Likeness
唇	Lips
掌	Manipulate
婆	Old Woman
哀	Pathetic
虹	Rainbow
爽	Refreshing
憩	Rest
尺	Shaku
砕	Smash
粘	Sticky
畳	Tatami Mat
胴	Torso
巾	Towel
芯	Wick
柳	Willow
遂	Accomplish
蓄	Amass
脇	Armpit
殴	Assault
咲	Blossom
鉢	Bowl
賢	Clever
彩	Coloring
隙	Crevice
培	Cultivate
踊	Dance
闇	Darkness
斜	Diagonal
尽	Exhaust
霜	Frost
穫	Harvest
麻	Hemp
騎	Horse
辱	Humiliate
灯	Lamp
畜	Livestock
溶	Melt
蚊	Mosquito
帳	Notebook
塗	Paint
貼	Paste
輝	Radiance
憶	Recollection
悔	Regret
耐	Resistant
盾	Shield
蛇	Snake
班	Squad
飢	Starve
餓	Starve
迅	Swift
脅	Threaten
概	Approximation
拘	Arrest
煮	Boil
覆	Capsize
駒	Chess Piece
悟	Comprehension
慌	Confused
謀	Conspire
鶴	Crane
拓	Cultivation
衰	Decline
奨	Encourage
淡	Faint
礎	Foundation
陛	Highness
浸	Immersed
劣	Inferiority
勘	Intuition
隔	Isolate
蹴	Kick
桑	Mulberry
尼	Nun
珠	Pearl
抽	Pluck
壇	Podium
陶	Pottery
妃	Princess
刈	Prune
紫	Purple
唯	Solely
剛	Sturdy
征	Subjugate
誓	Vow
俗	Vulgar
潤	Watered
肯	Agreement
浦	Bay
挟	Between
沸	Boil
瓶	Bottle
召	Call
貞	Chastity
亮	Clear
襟	Collar
隅	Corner
郡	County
燥	Dry Up
釈	Explanation
脂	Fat
偉	Greatness
軒	House Counter
蓮	Lotus
慈	Mercy
塚	Mound
玄	Mysterious
肪	Obese
耕	Plow
媛	Princess
邸	Residence
喚	Scream
苗	Seedling
隻	Ship Counter
膚	Skin
軟	Soft
郊	Suburbs
頂	Summit
濯	Wash
渦	Whirlpool
聡	Wise
枯	Wither
祥	Auspicious
呂	Bath
偏	Biased
茨	Briar
陥	Cave In
鎖	Chain
賠	Compensation
恒	Constant
綾	Design
没	Die
擁	Embrace
遭	Encounter
噴	Erupt
殊	Especially
倫	Ethics
陳	Exhibit
隼	Falcon
乃	From
輔	Help
猟	Hunting
唆	Instigate
怠	Lazy
惰	Lazy
覇	Leadership
須	Necessary
牲	Offering
秩	Order
孤	Orphan
芳	Perfume
貫	Pierce
糧	Provisions
颯	Quick
慢	Ridicule
膨	Swell
遇	Treatment
諭	Admonish
随	All
胡	Barbarian
搭	Board
錦	Brocade
鯉	Carp
胞	Cell
浄	Cleanse
帥	Commander
諒	Comprehend
蒙	Darkness
曙	Dawn
惨	Disaster
稿	Draft
啓	Enlighten
披	Expose
繊	Fiber
徐	Gently
葵	Hollyhock
騰	Inflation
据	Install
莉	Jasmine
緯	Latitude
瓜	Melon
虐	Oppress
戴	Receive
艇	Rowboat
丹	Rust Colored
緋	Scarlet
准	Semi
舗	Shop
壌	Soil
駿	Speed
剰	Surplus
寛	Tolerance
庶	All
且	Also
顕	Appear
杏	Apricot
栞	Bookmark
欄	Column
冠	Crown
酷	Cruel
叙	Describe
逸	Deviate
紋	Family Crest
阿	Flatter
愚	Foolish
尚	Furthermore
拐	Kidnap
悠	Leisure
勲	Merit
疎	Neglect
謡	Noh Chanting
哺	Nurse
栽	Planting
践	Practice
呈	Present
傲	Proud
疾	Rapidly
茜	Red Dye
酬	Repay
呆	Shock
鎌	Sickle
粛	Solemn
茎	Stem
痴	Stupid
荘	Villa
鯨	Whale
卸	Wholesale
累	Accumulate
伏	Bow
虜	Captive
循	Circulation
粗	Coarse
凝	Congeal
栓	Cork
瑛	Crystal
旦	Dawn
奉	Dedicate
遼	Distant
郭	Enclosure
抹	Erase
佳	Excellent
惜	Frugal
憂	Grief
悼	Grieve
癒	Healing
栃	Horse Chestnut
龍	Imperial
弥	Increasing
髄	Marrow
傍	Nearby
愉	Pleasant
赴	Proceed
昌	Prosperous
憾	Remorse
朴	Simple
脊	Stature
該	The Above
之	This
鎮	Tranquilize
尿	Urine
賓	VIP
那	What
匠	Artisan
拍	Beat
縛	Bind
飽	Bored
柴	Brushwood
蝶	Butterfly
弦	Chord
凛	Cold
庸	Common
轄	Control
悦	Delight
窮	Destitute
嘉	Esteem
弊	Evil
遥	Far Off
洪	Flood
紳	Gentleman
呉	Give
穀	Grain
摂	In Addition
寂	Lonely
宰	Manager
陵	Mausoleum
凡	Mediocre
尉	Military Officer
錯	Mixed
靖	Peaceful
恭	Respect
縫	Sew
舶	Ship
搾	Squeeze
猶	Still
窒	Suffocate
碑	Tombstone
智	Wisdom
款	Article
盲	Blind
醸	Brew
凹	Concave
弔	Condolence
凸	Convex
烏	Crow
敢	Daring
堕	Degenerate
鼓	Drum
衡	Equilibrium
伐	Fell
酵	Fermentation
閲	Inspection
遮	Intercept
腸	Intestines
瑠	Lapis Lazuli
乙	Latter
楓	Maple
膜	Membrane
紺	Navy
蒼	Pale
漬	Pickle
哉	Question Mark
峡	Ravine
賊	Robber
旋	Rotation
俸	Salary
喝	Scold
羅	Spread Out
萌	Sprout
槽	Tank
坪	Two Mat Area
遍	Universal
胎	Womb
陪	Accompany
扶	Aid
迭	Alternate
鶏	Chicken
瑞	Congratulations
暁	Dawn
剖	Divide
凌	Endure
藩	Fiefdom
譜	Genealogy
璃	Glassy
淑	Graceful
傑	Greatness
殻	Husk
錠	Lock
媒	Mediator
濁	Muddy
椎	Oak
赦	Pardon
戯	Play
享	Receive
嘱	Request
肖	Resemblance
憤	Resent
漣	Ripples
朽	Rot
奔	Run
帆	Sail
菅	Sedge
酌	Serve
慨	Sigh
絹	Silk
窃	Steal
硫	Sulfur
亜	Asia
屯	Barracks
岬	Cape
鋳	Cast
拙	Clumsy
詠	Compose
慶	Congratulate
酪	Dairy
篤	Deliberate
侮	Despise
堪	Endure
禍	Evil
雌	Female
睦	Friendly
胆	Guts
擬	Imitate
漆	Lacquer
閑	Leisure
憧	Long For
卑	Lowly
姻	Marry
忌	Mourning
曹	Official
峠	Peak
吟	Recital
礁	Reef
沙	Sand
蔑	Scorn
汰	Select
紡	Spinning
遷	Transition
叔	Uncle
甚	Very
浪	Wander
梓	Wood Block
崇	Worship
