行く	go	[いく]
見る	see, look at	[みる]
多い	a lot of, many	[おおい]
家	home, household	[うち]
これ	this, this one
それ	that, that one
私	I (general)	[わたし]
仕事	work, job	[しごと]
いつ	when
する	do, make
出る	go out, leave	[でる]
使う	use, make use of	[つかう]
所	place	[ところ]
作る	make, create	[つくる]
思う	think	[おもう]
持つ	have, possess	[もつ]
買う	buy	[かう]
時間	time, hour	[じかん]
知る	know	[しる]
同じ	same, identical	[おなじ]
今	now	[いま]
新しい	new	[あたらしい]
なる	become
まだ	(not) yet, still
あと	after
聞く	hear, ask, listen	[きく]
言う	say, tell	[いう]
少ない	few, little	[すくない]
高い	high, tall	[たかい]
子供	child	[こども]
そう	so, that way
もう	already, yet
学生	student	[がくせい]
熱い	hot (to touch)	[あつい]
どうぞ	please
午後	afternoon, p.m.	[ごご]
長い	long	[ながい]
本	book	[ほん]
今年	this year (colloquial)	[ことし]
よく	often, well
彼女	she, girlfriend	[かのじょ]
どう	how, what
言葉	word, language	[ことば]
顔	face	[かお]
終わる	finish, end	[おわる]
一つ	one (thing)	[ひとつ]
あげる	give, offer (colloquial)
こう	like this, such
学校	school	[がっこう]
くれる	be given
始める	start (something)	[はじめる]
起きる	get up, get out of bed	[おきる]
春	spring	[はる]
午前	morning, a.m.	[ごぜん]
別	another, different	[べつ]
どこ	where
部屋	room	[へや]
若い	young	[わかい]
車	car, automobile	[くるま]
置く	put, place	[おく]
住む	live, reside	[すむ]
働く	work	[はたらく]
難しい	difficult	[むずかしい]
先生	teacher (colloquial)	[せんせい]
立つ	stand, rise	[たつ]
呼ぶ	call, name	[よぶ]
大学	university, college	[だいがく]
安い	cheap, inexpensive	[やすい]
もっと	more
帰る	go back home	[かえる]
分かる	understand	[わかる]
広い	wide, big	[ひろい]
数	number	[かず]
近い	near, close	[ちかい]
そこ	there
走る	run	[はしる]
入れる	put in	[いれる]
教える	teach, tell	[おしえる]
歩く	walk, go on foot	[あるく]
会う	meet	[あう]
書く	write	[かく]
頭	head	[あたま]
売る	sell	[うる]
大好き	like (something) a lot	[だいすき]
体	body, physique, physical condition	[からだ]
直ぐ	at once, soon	[すぐ]
飛ぶ	fly	[とぶ]
とても	very (colloquial)
誰	who	[だれ]
好き	favorite, liked	[すき]
読む	read	[よむ]
次	next	[つぎ]
あなた	you
飲む	drink	[のむ]
古い	old	[ふるい]
質問	question	[しつもん]
今日	today (colloquial)	[きょう]
友達	friend, companion (colloquial)	[ともだち]
早い	early	[はやい]
どれ	what, which
美しい	beautiful	[うつくしい]
いつも	always (colloquial)
足	leg, foot	[あし]
起こす	wake (someone) up	[おこす]
見せる	show	[みせる]
娘	daughter, girl	[むすめ]
楽しむ	enjoy	[たのしむ]
色	color	[いろ]
みんな	everybody (colloquial)
取る	take, get	[とる]
勉強	study	[べんきょう]
できる	can do, be good at
短い	short, brief	[みじかい]
落ちる	fall, come down	[おちる]
息子	son	[むすこ]
白い	white, blank	[しろい]
飛行機	airplane	[ひこうき]
病気	illness	[びょうき]
冬	winter	[ふゆ]
年	year, age	[とし]
重い	heavy	[おもい]
胸	chest, breast	[むね]
払う	pay (money, respect, attention, etc.)	[はらう]
軽い	light (of weight, degree, etc.)	[かるい]
見つける	find	[みつける]
忘れる	forget, leave behind	[わすれる]
酒	alcohol, rice wine	[さけ]
どちら	which (polite)
姉	(one's own) older sister	[あね]
覚える	memorize, learn	[おぼえる]
狭い	narrow, small	[せまい]
赤い	red	[あかい]
着る	wear, put on	[きる]
笑う	laugh, smile	[わらう]
一番	most, best	[いちばん]
授業	class session, lecture	[じゅぎょう]
週	week	[しゅう]
漢字	Chinese character	[かんじ]
自転車	bicycle	[じてんしゃ]
電車	train	[でんしゃ]
探す	search for, look for (someone or something one wants)	[さがす]
紙	paper	[かみ]
歌う	sing	[うたう]
遅い	slow, late	[おそい]
首	neck	[くび]
速い	fast	[はやい]
一緒に	together, at the same time	[いっしょに]
今月	this month	[こんげつ]
遊ぶ	play	[あそぶ]
遠い	far, distant	[とおい]
弱い	weak	[よわい]
耳	ear	[みみ]
座る	sit, sit down	[すわる]
右	right	[みぎ]
浴びる	take (a shower), bask	[あびる]
肩	shoulder	[かた]
寝る	sleep, go to sleep	[ねる]
消す	switch off, turn off	[けす]
元気	healthy, energetic	[げんき]
全部	all, whole	[ぜんぶ]
去年	last year (colloquial)	[きょねん]
引く	draw, pull	[ひく]
図書館	library	[としょかん]
上げる	raise, lift	[あげる]
緑	green color, greenery	[みどり]
腕	arm	[うで]
ドア	door (loan word)
女の子	little girl	[おんなのこ]
男の子	boy	[おとこのこ]
私たち	we (colloquial)	[わたしたち]
近く	near, close to	[ちかく]
やる	do, give
かなり	fairly, rather
国	country	[くに]
起こる	happen	[おこる]
秋	autumn, fall	[あき]
送る	send	[おくる]
死ぬ	die	[しぬ]
気持ち	feeling, sensation	[きもち]
乗る	ride, take	[のる]
いる	be present, stay
木	tree, wood	[き]
開ける	open, unlock (doors, windows, etc.)	[あける]
閉める	shut, close (doors, windows, etc.)	[しめる]
続く	continue, follow	[つづく]
お医者さん	doctor (polite)	[おいしゃさん]
円	Japanese yen	[えん]
ここ	here
待つ	wait, wait for	[まつ]
低い	low, short	[ひくい]
もらう	receive, get (something from someone)
食べる	eat	[たべる]
兄	(one's own) older brother	[あに]
名前	name	[なまえ]
夫	husband	[おっと]
一	one	[いち]
結婚	marriage	[けっこん]
親	parent	[おや]
話す	speak, talk	[はなす]
少し	a bit, a little while	[すこし]
閉じる	shut, close (books, eyes, etc.)	[とじる]
時	time, moment	[とき]
米	rice (grain)	[こめ]
切る	cut	[きる]
楽しい	fun, enjoyable	[たのしい]
服	clothes (colloquial)	[ふく]
後ろ	back, behind	[うしろ]
嬉しい	happy, glad	[うれしい]
腰	waist, lower back	[こし]
日曜日	Sunday	[にちようび]
昼	daytime, midday	[ひる]
お母さん	mother, mom (colloquial)	[おかあさん]
大学生	university student	[だいがくせい]
終わり	end, finish	[おわり]
背	height, stature	[せ]
手伝う	help, assist	[てつだう]
鼻	nose	[はな]
起きる	occur, happen	[おきる]
載せる	place, put on	[のせる]
悲しい	sad	[かなしい]
しゃべる	chat, talk
近く	in the near future, before long	[ちかく]
甘い	sweet	[あまい]
テーブル	table
食べ物	food (colloquial)	[たべもの]
始まる	begin	[はじまる]
ゲーム	game (loan word)
十	ten	[じゅう]
天気	weather	[てんき]
暑い	hot (of weather)	[あつい]
太い	thick, fat	[ふとい]
晩	evening, night (from sunset to bedtime)	[ばん]
土曜日	Saturday	[どようび]
痛い	sore, painful	[いたい]
お父さん	father, dad (colloquial)	[おとうさん]
多分	probably, perhaps	[たぶん]
時計	clock, watch	[とけい]
泊まる	stay overnight	[とまる]
どうして	how come
掛ける	hang, put on	[かける]
曲がる	make a turn, turn	[まがる]
お腹	stomach, belly	[おなか]
ミーティング	meeting (loan word)
嫌い	hate, dislike	[きらい]
金曜日	Friday	[きんようび]
要る	need, require	[いる]
無い	to not be	[ない]
黄色い	yellow	[きいろい]
風邪	cold (illness)	[かぜ]
優しい	gentle, kind	[やさしい]
晴れる	be sunny, clear up	[はれる]
汚い	dirty	[きたない]
茶色	brown	[ちゃいろ]
空く	be empty, become less crowded	[すく]
上る	go up, climb	[のぼる]
ご飯	meal, cooked rice	[ごはん]
日	counter for days	[にち]
髪の毛	hair, each single hair	[かみのけ]
つける	switch on, turn on
月曜日	Monday	[げつようび]
入る	enter	[はいる]
カタカナ	katakana
今週	this week	[こんしゅう]
開く	open (books, eyes, etc.)	[ひらく]
水	water	[みず]
あれ	that (over there)
二	two	[に]
締める	tighten, fasten	[しめる]
まずい	bad (taste), distasteful
平仮名	hiragana	[ひらがな]
曇る	become cloudy	[くもる]
触る	touch, feel	[さわる]
駄目	no good	[だめ]
飲み物	beverage, drink	[のみもの]
木曜日	Thursday	[もくようび]
曜日	day of the week	[ようび]
そば	side, vicinity
こっち	here, this way (casual)
火曜日	Tuesday	[かようび]
渇く	be thirsty	[かわく]
三	three	[さん]
水曜日	Wednesday	[すいようび]
二つ	two (things)	[ふたつ]
今晩	this evening, tonight	[こんばん]
千	thousand	[せん]
六日	six days, sixth of the month	[むいか]
お姉さん	older sister	[おねえさん]
直る	be repaired, get fixed	[なおる]
ちょっと	just a moment, just a little
四	four (Japanese origin)	[よん]
これから	from now on, after this
考える	think, consider	[かんがえる]
戻る	return to a point of departure	[もどる]
変える	change (something), alter	[かえる]
朝	morning	[あさ]
歯	tooth	[は]
頑張る	work hard, do one's best	[がんばる]
携帯電話	cellular phone	[けいたいでんわ]
雨	rain	[あめ]
金	money (colloquial)	[かね]
易しい	easy, simple (colloquial)	[やさしい]
お兄さん	older brother	[おにいさん]
大きい	big	[おおきい]
小さい	small	[ちいさい]
辛い	spicy, hot	[からい]
八	eight	[はち]
あそこ	over there
来る	come	[くる]
前	front, before	[まえ]
五日	five days, fifth of the month	[いつか]
いっぱい	full, a lot
九	nine (used before counter words and in decimal places)	[きゅう]
酸っぱい	sour	[すっぱい]
違う	differ, be wrong	[ちがう]
細い	thin, slender	[ほそい]
三つ	three (things)	[みっつ]
八日	eight days, eighth of the month	[ようか]
高校生	high school student	[こうこうせい]
上手	good, skilled	[じょうず]
強い	strong	[つよい]
七	seven (Japanese origin)	[なな]
二十日	20 days, 20th of the month	[はつか]
左	left	[ひだり]
二日	two days, second of the month	[ふつか]
四つ	four (things)	[よっつ]
暖かい	warm	[あたたかい]
ある	exist, there is
いい	good (informal/spoken form)
上	up, above	[うえ]
駅	train station	[えき]
美味しい	tasty	[おいしい]
昨日	yesterday (colloquial)	[きのう]
綺麗	pretty, clean	[きれい]
五	five	[ご]
九つ	nine (things)	[ここのつ]
お願い	favor	[おねがい]
答える	give an answer	[こたえる]
先	ahead, first	[さき]
寒い	cold (temperature of the air)	[さむい]
四	four (Chinese origin)	[し]
三日	three days, third of the month	[みっか]
下	under, below	[した]
大丈夫	all right, OK	[だいじょうぶ]
大人	adult	[おとな]
出す	take out	[だす]
父	(one's own) father	[ちち]
母	(one's own) mother	[はは]
月	moon	[つき]
妹	younger sister	[いもうと]
冷たい	cold (to touch)	[つめたい]
弟	younger brother	[おとうと]
手	hand	[て]
十日	ten days, tenth of the month	[とおか]
口	mouth	[くち]
夏	summer	[なつ]
七つ	seven (things)	[ななつ]
時々	sometimes	[ときどき]
何	what	[なに]
人	person	[ひと]
一人	one person	[ひとり]
一日	first of the month	[ついたち]
九日	nine days, ninth of the month	[ここのか]
方	direction, side	[ほう]
他	other (Japanese origin)	[ほか]
僕	I, me (usually used by young males)	[ぼく]
欲しい	want, desire (of the speaker)	[ほしい]
万	ten thousand	[まん]
見える	be visible, can see	[みえる]
道	street, way	[みち]
五つ	five (things)	[いつつ]
目	eye	[め]
八つ	eight (things)	[やっつ]
止める	stop, give up	[やめる]
四日	four days, fourth of the month	[よっか]
夜	night (from sunset to sunrise)	[よる]
来年	next year	[らいねん]
六	six	[ろく]
悪い	bad	[わるい]
お手洗い	rest room, lavatory	[おてあらい]
ご主人	(someone else's) husband	[ごしゅじん]
本当に	really, truly	[ほんとうに]
自分	self, oneself	[じぶん]
ため	sake, purpose
見つかる	be found, be caught	[みつかる]
休む	take a rest, take a break	[やすむ]
ゆっくり	slowly
六つ	six (things)	[むっつ]
花	flower	[はな]
動く	move	[うごく]
線	line	[せん]
七日	seven days, seventh of the month	[なのか]
以外	except for	[いがい]
男	man, male	[おとこ]
彼	he, one's boyfriend	[かれ]
女	woman	[おんな]
妻	(one's own) wife	[つま]
百	hundred	[ひゃく]
辺	vicinity	[へん]
店	shop, store	[みせ]
閉まる	be shut, be closed	[しまる]
問題	problem, question	[もんだい]
必要	need, necessary	[ひつよう]
もつ	last long, be durable
開く	open	[あく]
昨年	last year (formal, often used in writing)	[さくねん]
治る	be cured, get well	[なおる]
ドル	dollar
システム	system (loan word)
以上	more than, not less than	[いじょう]
最近	recent, latest	[さいきん]
世界	world	[せかい]
コンピューター	computer
やる	give (to an inferior)
意味	meaning, sense	[いみ]
増える	increase, accrue	[ふえる]
選ぶ	choose, elect	[えらぶ]
生活	life, living	[せいかつ]
進める	go ahead with, proceed	[すすめる]
続ける	continue, keep up	[つづける]
ほとんど	almost, hardly
会社	company, corporation	[かいしゃ]
家	house, dwelling	[いえ]
多く	much, largely	[おおく]
話	talk, story	[はなし]
上がる	go up, rise (physical movement)	[あがる]
もう	another, again
集める	collect, gather	[あつめる]
声	voice, sound	[こえ]
初めて	for the first time	[はじめて]
変わる	change, turn into	[かわる]
まず	first of all, to begin with
社会	society	[しゃかい]
プログラム	program booklet
力	strength, power	[ちから]
今回	this time	[こんかい]
予定	schedule, plan	[よてい]
まま	as is, still (in the current state)
テレビ	television
減る	decrease, diminish	[へる]
消える	be extinguished, disappear	[きえる]
家族	family, household	[かぞく]
比べる	compare, contrast	[くらべる]
生まれる	be born, come into existence	[うまれる]
ただ	free of charge
これら	these
調べる	investigate, check	[しらべる]
事故	accident, trouble	[じこ]
電話	telephone, phone call	[でんわ]
外国	foreign country	[がいこく]
銀行	bank	[ぎんこう]
十分	enough, plentiful	[じゅうぶん]
あまり	(not) much
写真	photograph	[しゃしん]
繰り返す	repeat	[くりかえす]
種類	kind, type	[しゅるい]
意見	opinion	[いけん]
新聞	newspaper	[しんぶん]
文章	sentence, writing	[ぶんしょう]
目立つ	stand out, be conspicuous	[めだつ]
相手	opponent, the other party	[あいて]
病院	hospital	[びょういん]
厚い	thick, bulky	[あつい]
忙しい	busy, occupied	[いそがしい]
薄い	thin, weak	[うすい]
川	river, stream	[かわ]
暗い	dark, gloomy	[くらい]
クラス	class (in school)
黒い	black, dark	[くろい]
バス	bus
青い	blue	[あおい]
買い物	shopping, purchase	[かいもの]
薬	drug, medicine	[くすり]
砂糖	sugar	[さとう]
休み	holiday, break	[やすみ]
郵便局	post office	[ゆうびんきょく]
住所	address	[じゅうしょ]
こちら	here, this way (polite)
財布	purse, wallet	[さいふ]
パスポート	passport
椅子	chair	[いす]
可愛い	cute, sweet	[かわいい]
お祖父さん	grandfather (colloquial)	[おじいさん]
切手	postage stamp	[きって]
涼しい	cool (of temperature)	[すずしい]
いくつ	how many, how old
メニュー	menu
電気	electricity, electric light	[でんき]
勝つ	win	[かつ]
負ける	lose (a game), be defeated	[まける]
建てる	build, erect	[たてる]
日記	diary	[にっき]
売り切れ	sellout, sold out	[うりきれ]
お巡りさん	police officer (colloquial)	[おまわりさん]
目覚まし時計	alarm clock	[めざましどけい]
レシート	receipt (loan word)
ティッシュ	tissue, Kleenex
歯ブラシ	toothbrush	[はブラシ]
下りる	go down, come down	[おりる]
洗う	wash	[あらう]
パート	part-time
氏名	full name	[しめい]
今夜	tonight, this evening	[こんや]
夜中	midnight	[よなか]
来週	next week	[らいしゅう]
誰か	someone	[だれか]
何	what (used with t, d, n consonants and counters)	[なん]
今朝	this morning	[けさ]
寿司	sushi	[すし]
履く	put on (shoes), wear (pants, skirt)	[はく]
おじさん	uncle
おばさん	aunt
お祖母さん	grandmother (colloquial), elderly woman	[おばあさん]
いとこ	cousin
辞書	dictionary (category)	[じしょ]
朝ご飯	breakfast (colloquial)	[あさごはん]
白	white color	[しろ]
どっち	which (casual)
そっち	there (casual)
明日	tomorrow (colloquial)	[あした]
明後日	day after tomorrow (colloquial)	[あさって]
一昨日	the day before yesterday (colloquial)	[おととい]
庭	garden, yard	[にわ]
左側	left side	[ひだりがわ]
右側	right side	[みぎがわ]
指	finger, toe	[ゆび]
眼鏡	glasses	[めがね]
鞄	bag, handbag	[かばん]
あっち	other side, over there (casual)
大人しい	gentle, quiet	[おとなしい]
下手	bad at, unskilled	[へた]
厳しい	strict, severe	[きびしい]
一人で	by oneself, alone	[ひとりで]
答え	answer, solution	[こたえ]
この頃	these days, recently	[このごろ]
残念	regretful, disappointing	[ざんねん]
仕舞う	put away, put in	[しまう]
心配	anxiety, worry	[しんぱい]
外	outside, open air	[そと]
大切	important, valuable	[たいせつ]
ちょうど	just, exactly
助ける	help, save	[たすける]
勤める	serve, hold a job	[つとめる]
連れていく	take along, bring along (a person)	[つれていく]
丈夫	healthy, sturdy	[じょうぶ]
賑やか	lively, exciting	[にぎやか]
眠い	sleepy	[ねむい]
山	mountain	[やま]
橋	bridge	[はし]
止まる	come to a stop, cease	[とまる]
降る	fall, come down (rain, snow, etc.)	[ふる]
本当	reality, genuine	[ほんとう]
町	town	[まち]
お菓子	sweets, snacks	[おかし]
緩い	slack, loose	[ゆるい]
良い	good (formal/written form)	[よい]
ようこそ	welcome (greeting)
お土産	souvenir (polite)	[おみやげ]
両親	parents	[りょうしん]
ウェーター	waiter
ウェートレス	waitress
絶対に	absolutely, definitely	[ぜったいに]
ごちそう	feast, treat
フォーク	fork
スプーン	spoon
瓶	bottle	[びん]
付く	be on, be switched on	[つく]
醤油	soy sauce	[しょうゆ]
茶碗	rice bowl	[ちゃわん]
決める	decide, agree upon	[きめる]
感じる	feel, sense	[かんじる]
生きる	live (one's life)	[いきる]
動かす	move (something)	[うごかす]
壊れる	break, break down	[こわれる]
復習	review	[ふくしゅう]
眉	eyebrow	[まゆ]
客	visitor, customer	[きゃく]
机	desk	[つくえ]
風呂	bath	[ふろ]
湯	hot water	[ゆ]
ぬるい	tepid, lukewarm
風邪薬	cold medicine	[かぜぐすり]
靴下	socks	[くつした]
たばこ	tobacco, cigarette
アイスコーヒー	iced coffee
天ぷら	Japanese deep-fried food	[てんぷら]
肉	flesh, meat	[にく]
昨夜	last night, last evening (colloquial)	[ゆうべ]
流行る	be in fashion, be popular	[はやる]
連れてくる	bring (a person)	[つれてくる]
方	person (polite form)	[かた]
零	zero	[れい]
雲	cloud	[くも]
空	sky	[そら]
人気	popularity	[にんき]
兄さん	(one's own) older brother (polite)	[にいさん]
姉さん	(one's own) older sister (polite)	[ねえさん]
平成	Heisei era	[へいせい]
毎月	every month	[まいつき]
半日	half a day	[はんにち]
半月	half a month	[はんつき]
なるほど	I see, now I understand
つまり	in short, that is to say
そのまま	as it is, just like that
はっきり	clearly
大変	awful, hard	[たいへん]
簡単	simple, easy	[かんたん]
似ている	look like, resemble	[にている]
驚く	be surprised, be startled	[おどろく]
嫌	dislike, don't like	[いや]
喧嘩	fight, argument	[けんか]
遅れる	be late	[おくれる]
にんじん	carrot
ジャガイモ	potato
ナス	eggplant
やかん	kettle
話し合う	discuss, talk over	[はなしあう]
残す	leave, leave undone	[のこす]
ごちそうする	treat, host (a meal)
合う	fit, match	[あう]
当たる	(go straight and) hit, strike	[あたる]
集まる	gather, be collected	[あつまる]
場所	place, space	[ばしょ]
海	sea, ocean	[うみ]
少年	boy (between 7 and 18 years old)	[しょうねん]
孫	grandchild	[まご]
生徒	pupil, student	[せいと]
高校	high school (for short)	[こうこう]
年上	older, senior	[としうえ]
卒業	graduation	[そつぎょう]
運動	movement, exercise	[うんどう]
選手	athlete, (sports) player	[せんしゅ]
映画	movie	[えいが]
英語	English	[えいご]
手紙	letter	[てがみ]
動物	animal	[どうぶつ]
音	sound, noise	[おと]
海外	overseas, abroad	[かいがい]
外国人	foreigner	[がいこくじん]
帰国	return to one's country	[きこく]
彼ら	they	[かれら]
機械	machine	[きかい]
基本	basics	[きほん]
今度	this time, next time	[こんど]
最後	last	[さいご]
最初	first, outset	[さいしょ]
準備	preparation, arrangement	[じゅんび]
進む	advance, move forward	[すすむ]
直接	directly	[ちょくせつ]
特に	specially, particularly	[とくに]
届く	reach, be received	[とどく]
なぜ	why
並ぶ	line up, be parallel	[ならぶ]
運ぶ	carry, transport	[はこぶ]
直す	repair, fix	[なおす]
反対	oppose, object	[はんたい]
場合	situation, case	[ばあい]
詳しい	detailed, have detailed knowledge	[くわしい]
いたずら	mischief, prank
お祝い	celebration	[おいわい]
くし	comb
こぼれる	spill, overflow
伝える	convey, transmit	[つたえる]
膝	knee	[ひざ]
肘	elbow	[ひじ]
枕	pillow	[まくら]
建物	building, structure	[たてもの]
道路	road	[どうろ]
四つ角	intersection	[よつかど]
曲がり角	corner (to turn)	[まがりかど]
警察	police	[けいさつ]
空気	air, atmosphere	[くうき]
スポーツ	sport
チャンス	chance
クリーニング	dry cleaning
サービス	service
グループ	group
自宅	one's house, one's home	[じたく]
家庭	home, family	[かてい]
期間	term, period	[きかん]
年度	year, school year	[ねんど]
経験	experience, knowledge or skill gained	[けいけん]
安全	safety, security	[あんぜん]
危険	danger, dangerous	[きけん]
注意	attention, care	[ちゅうい]
成功	success	[せいこう]
努力	endeavor, effort	[どりょく]
説明	explanation, description	[せつめい]
地震	earthquake	[じしん]
手術	surgical operation	[しゅじゅつ]
火傷	burn	[やけど]
課題	task, assignment	[かだい]
子	young child, kid	[こ]
確認	confirmation	[かくにん]
実際	reality, actual state	[じっさい]
国際	international	[こくさい]
会議	conference, meeting	[かいぎ]
提案	suggestion, proposal	[ていあん]
事務所	office, one's place of business	[じむしょ]
教授	professor	[きょうじゅ]
世紀	century	[せいき]
あちこち	all over, here and there
そちら	there (polite)
あちら	over there (polite)
もし	if, in case of
うるさい	noisy, annoying
固い	stiff, tight	[かたい]
深い	deep, profound	[ふかい]
面白い	interesting, funny	[おもしろい]
全く	entirely, truly	[まったく]
半分	half	[はんぶん]
普通	normal, regular	[ふつう]
分	amount, share	[ぶん]
文化	culture	[ぶんか]
毎日	every day	[まいにち]
気を付ける	be careful about, pay attention to	[きをつける]
守る	protect, observe	[まもる]
もちろん	of course
やはり	as expected
いくら	how much (money)
よろしく	one's regards
どなた	who (polite)
許す	permit, forgive	[ゆるす]
分ける	divide, share	[わける]
自然	nature	[しぜん]
アパート	apartment, flat
ホテル	hotel
パソコン	personal computer
うまい	good at
明るい	bright, cheerful	[あかるい]
急ぐ	hurry, do quickly	[いそぐ]
歌	song	[うた]
中学校	junior high school	[ちゅうがっこう]
テスト	test
ポスト	postbox, mailbox
ハンカチ	handkerchief
髪	hair, hairstyle	[かみ]
帽子	hat, cap	[ぼうし]
被る	wear, put on (on one's head)	[かぶる]
ブラウス	blouse
週末	weekend	[しゅうまつ]
先週	last week	[せんしゅう]
再来週	the week after next	[さらいしゅう]
いつか	some time, some day
宿題	homework	[しゅくだい]
鍵	key, lock	[かぎ]
傘	umbrella	[かさ]
乗り換える	change, transfer	[のりかえる]
向かう	face, head toward	[むかう]
本屋	bookstore (colloquial)	[ほんや]
お茶	tea (polite)	[おちゃ]
改札口	ticket gate	[かいさつぐち]
晴れ	fine weather, clear sky	[はれ]
バス停	bus stop	[バスてい]
曇り	cloudy weather	[くもり]
塩	salt	[しお]
たくさん	a lot, in large quantity
大嫌い	hate	[だいきらい]
中	inside, middle	[なか]
二階	second floor, upstairs	[にかい]
無くす	lose, get rid of	[なくす]
まあまあ	OK, not bad
黄色	yellow color	[きいろ]
ランチ	lunch (loan word)
魚	fish	[さかな]
味	taste, flavor	[あじ]
りんご	apple
みかん	mandarin orange
皿	plate, counter (for plates or helpings)	[さら]
コーヒー	coffee
コップ	cup, glass
二人	two persons	[ふたり]
止む	stop, cease	[やむ]
九	nine	[く]
昼間	daytime, during the day	[ひるま]
いつ頃	about when, about what time	[いつごろ]
字	(individual) character, letter	[じ]
七	seven (Chinese origin)	[しち]
お釣り	change (of money)	[おつり]
名字	surname, family name	[みょうじ]
おじ	(one's own) uncle
おば	(one's own) aunt
祖父	(one's own) grandfather (formal)	[そふ]
祖母	(one's own) grandmother (formal)	[そぼ]
大事	importance	[だいじ]
見方	view, perspective	[みかた]
鳥	bird	[とり]
犬	dog	[いぬ]
返事	answer, reply	[へんじ]
また	again, also, or
年間	period of one year	[ねんかん]
青	blue, green	[あお]
赤	red color	[あか]
信号	signal, traffic light	[しんごう]
円	circle	[えん]
非常に	very, extremely	[ひじょうに]
複雑	complicated, intricate	[ふくざつ]
平和	peace, harmony	[へいわ]
回る	turn round, go around	[まわる]
若者	young person, youth	[わかもの]
雪	snow, snowfall	[ゆき]
うまい	delicious, tasty (used by male)
思い出す	recollect, recall	[おもいだす]
聞こえる	hear, be heard	[きこえる]
借りる	borrow	[かりる]
返す	return, repay	[かえす]
受け取る	receive, get	[うけとる]
捨てる	discard, abandon	[すてる]
一緒	together, same (colloquial)	[いっしょ]
遊び	game, amusement	[あそび]
移す	move, transfer	[うつす]
大きさ	size, dimension	[おおきさ]
考え	thought, idea	[かんがえ]
空港	airport (for public transportation)	[くうこう]
出発	departure, starting	[しゅっぱつ]
地図	map, atlas	[ちず]
運転	drive	[うんてん]
降りる	get off, land	[おりる]
ガス	gas (loan word)
必ず	without exception, always	[かならず]
カメラ	camera
通う	go to and from, frequent a place	[かよう]
急に	suddenly, unexpectedly	[きゅうに]
サラリーマン	salaried worker
給料	salary, pay	[きゅうりょう]
曲	piece of music	[きょく]
切れる	cut well, be sharp	[きれる]
正しい	correct, righteous	[ただしい]
苦しい	painful, agonizing	[くるしい]
細かい	minute, fine	[こまかい]
静か	quiet	[しずか]
健康	health	[けんこう]
ゴルフ	golf
コース	course, route
頼む	order, ask for	[たのむ]
困る	be in trouble, not know what to do	[こまる]
ずっと	all the time, all through
例えば	for example	[たとえば]
つもり	intention, purpose
しばらく	a little while, a while
紹介	introduction	[しょうかい]
小学校	elementary school	[しょうがっこう]
公園	park, public garden	[こうえん]
中学	junior high	[ちゅうがく]
成績	results, grade	[せいせき]
教科書	textbook, schoolbook	[きょうかしょ]
席	seat, one's place	[せき]
教室	classroom, class	[きょうしつ]
教師	teacher, instructor (formal)	[きょうし]
試験	exam	[しけん]
合格	passing an examination	[ごうかく]
数学	mathematics	[すうがく]
数字	numeric characters, number	[すうじ]
音楽	music	[おんがく]
食事	meal, food	[しょくじ]
壁	wall, partition	[かべ]
信じる	believe, trust	[しんじる]
育てる	bring up, raise	[そだてる]
倒れる	fall over	[たおれる]
落とす	drop	[おとす]
代わる	substitute, be substituted for	[かわる]
タクシー	taxi
確か	for sure, for certain	[たしか]
立てる	stand, set up	[たてる]
中学生	junior high school student	[ちゅうがくせい]
売れる	sell, be in demand	[うれる]
着く	arrive at, reach	[つく]
決まる	be decided	[きまる]
飾る	decorate	[かざる]
殺す	kill	[ころす]
下げる	lower, turn down	[さげる]
贈る	offer, give	[おくる]
訪ねる	visit, go to see	[たずねる]
打つ	hit, strike	[うつ]
相談	consultation, advice	[そうだん]
玄関	entrance, front door	[げんかん]
兄弟	sibling	[きょうだい]
長男	eldest son	[ちょうなん]
高さ	height	[たかさ]
用	things to do	[よう]
時代	age, era	[じだい]
位置	position, location	[いち]
季節	season	[きせつ]
穴	hole	[あな]
裏	the back, the reverse side	[うら]
島	island (Japanese origin)	[しま]
海岸	seashore, coast	[かいがん]
ガラス	glass (material)
自然	natural	[しぜん]
風	wind	[かぜ]
科学	science	[かがく]
太陽	sun	[たいよう]
台風	typhoon	[たいふう]
北	north	[きた]
馬	horse	[うま]
牛肉	beef	[ぎゅうにく]
雑誌	magazine, journal	[ざっし]
小説	novel	[しょうせつ]
大使館	embassy	[たいしかん]
故障	malfunction, breakdown	[こしょう]
温度	temperature	[おんど]
何か	something, some	[なにか]
向こう	over there, on the other side	[むこう]
真ん中	center, middle (casual)	[まんなか]
遠く	far away, distance	[とおく]
横	side, width across	[よこ]
つまらない	boring, dull
素晴らしい	excellent, wonderful	[すばらしい]
毎年	every year (colloquial)	[まいとし]
来月	next month	[らいげつ]
日時	date and time	[にちじ]
夕方	early evening, at dusk	[ゆうがた]
通る	pass, go through	[とおる]
自動車	automobile	[じどうしゃ]
慣れる	grow accustomed to, get used to	[なれる]
撮る	take (a photograph), film	[とる]
やっと	at last, finally (used only for a good outcome)
どんどん	knock, bang
並べる	line up, arrange	[ならべる]
逃げる	escape, run away	[にげる]
渡す	hand over, give	[わたす]
値段	price	[ねだん]
両方	both	[りょうほう]
約束	promise, vow	[やくそく]
一部	part	[いちぶ]
ラジオ	radio
入院	hospitalization	[にゅういん]
ニュース	news
旅行	travel, trip	[りょこう]
用意	preparation	[ようい]
伸びる	stretch, grow	[のびる]
パーティー	party
ビール	beer
早く	early, soon	[はやく]
番組	(television, radio) program	[ばんぐみ]
ビデオ	video
増やす	increase (something), add (something)	[ふやす]
振る	wave, shake	[ふる]
迎える	welcome, receive (a visitor)	[むかえる]
無理	unreasonable, impossible	[むり]
珍しい	rare, scarce	[めずらしい]
有名	famous	[ゆうめい]
喜ぶ	be happy, be delighted	[よろこぶ]
留学	studying abroad	[りゅうがく]
料理	cooking, dish	[りょうり]
野菜	vegetable	[やさい]
分かれる	be divided, split off	[わかれる]
特別	special	[とくべつ]
理由	reason, excuse	[りゆう]
自由	freedom	[じゆう]
方向	direction, course	[ほうこう]
残る	remain, be left over	[のこる]
ビル	building (loan word)
まとめる	gather together, put in order
流れる	flow, run	[ながれる]
セーター	sweater
シャツ	shirt
洗濯	laundry, washing	[せんたく]
間違える	make a (careless) mistake, fail at (something)	[まちがえる]
アイスクリーム	ice cream
乾く	become dry	[かわく]
冷める	cool off	[さめる]
色々	a variety of	[いろいろ]
持って行く	take, bring	[もっていく]
着替える	change clothes	[きがえる]
石鹸	soap	[せっけん]
野球	baseball	[やきゅう]
昼食	lunch (formal)	[ちゅうしょく]
朝食	breakfast (formal)	[ちょうしょく]
眠る	sleep, lie idle	[ねむる]
初め	first, beginning (in terms of time passage)	[はじめ]
火	fire, flame	[ひ]
西	west, western	[にし]
東	east, eastern	[ひがし]
南	south	[みなみ]
夕食	supper, dinner (formal)	[ゆうしょく]
なかなか	pretty, considerably
励ます	encourage, cheer up	[はげます]
涙	tear	[なみだ]
夢	dream	[ゆめ]
職場	place of work, office	[しょくば]
隣	next to, next door	[となり]
マンション	apartment, residential building
エレベーター	elevator
窓	window	[まど]
押す	push, press down	[おす]
入学	enter a school, matriculate	[にゅうがく]
戸	door, sliding door	[と]
通り	street, road	[とおり]
亡くなる	die, pass away	[なくなる]
夫婦	husband and wife, married couple	[ふうふ]
女性	woman, female (formal)	[じょせい]
森	forest	[もり]
トラック	truck
レコード	record
熱	heat, fever	[ねつ]
ページ	page
踊る	dance	[おどる]
長さ	length	[ながさ]
厚さ	thickness	[あつさ]
秘密	secret, privacy	[ひみつ]
凄い	great, incredible	[すごい]
親切	kind, kindhearted	[しんせつ]
絶対	absolutely, never	[ぜったい]
先月	last month	[せんげつ]
一昨年	the year before last (colloquial)	[おととし]
冬休み	winter vacation	[ふゆやすみ]
夏休み	summer vacation	[なつやすみ]
休日	day off, holiday	[きゅうじつ]
正月	New Year	[しょうがつ]
思い出	memory	[おもいで]
たまに	occasionally, sometimes
おかしい	strange, peculiar
浅い	shallow, superficial	[あさい]
君	you (referring to fellows or subordinates)	[きみ]
奥さん	(someone else's) wife, married woman	[おくさん]
赤ちゃん	baby (colloquial)	[あかちゃん]
小学生	elementary school student	[しょうがくせい]
貸す	lend, lease	[かす]
数える	count	[かぞえる]
生む	give birth, produce	[うむ]
育つ	be brought up, grow	[そだつ]
是非	by all means, please	[ぜひ]
黒	black color	[くろ]
おもちゃ	toy, plaything
靴	shoes	[くつ]
連絡	contact, communication	[れんらく]
伝言	message (left by someone)	[でんごん]
預ける	deposit, leave (something) with (someone)	[あずける]
下がる	go down, drop	[さがる]
泳ぐ	swim	[およぐ]
アルバイト	part-time job
コート	coat, jacket (loan word)
趣味	hobby, interest	[しゅみ]
散歩	walk, stroll	[さんぽ]
幸せ	happiness, satisfied (colloquial)	[しあわせ]
安心	peace of mind, relief	[あんしん]
大勢	large numbers, a lot of (people)	[おおぜい]
医者	doctor (colloquial, plain)	[いしゃ]
運転手	driver	[うんてんしゅ]
新幹線	bullet train	[しんかんせん]
往復	round trip	[おうふく]
コピー	copy, photocopy
奥	inner part, the back	[おく]
重さ	weight	[おもさ]
親しい	intimate, close	[したしい]
修理	repair, mending	[しゅうり]
カード	card
挨拶	greet, greeting	[あいさつ]
階段	steps, flight of stairs	[かいだん]
配る	hand out, distribute	[くばる]
断る	refuse, turn down	[ことわる]
グラム	gram
濃い	strong, concentrated	[こい]
壊す	break (something), destroy	[こわす]
桜	cherry tree, cherry blossom	[さくら]
仕方	way, method	[しかた]
絵	picture, painting	[え]
気温	air temperature	[きおん]
品物	article, goods	[しなもの]
吸う	inhale, suck	[すう]
案内	guide, guidance	[あんない]
スキー	ski, skiing
金持ち	wealthy person	[かねもち]
尋ねる	inquire, ask	[たずねる]
叩く	tap, hit	[たたく]
帰り	return, going home	[かえり]
卵	egg	[たまご]
氷	ice	[こおり]
留学生	student studying abroad	[りゅうがくせい]
ソフト	software, program (for short)
歯医者	dentist	[はいしゃ]
蹴る	kick	[ける]
敷く	lay, spread	[しく]
ひととき	some moments, a while
交通事故	traffic accident	[こうつうじこ]
遭う	encounter, get caught in	[あう]
招待	invitation	[しょうたい]
咲く	bloom, blossom	[さく]
二十歳	20 years old	[はたち]
銀	silver	[ぎん]
内側	inside, interior	[うちがわ]
池	pond	[いけ]
石	stone, small rock	[いし]
愛	love	[あい]
課	section, division	[か]
大学院	graduate school	[だいがくいん]
台所	kitchen	[だいどころ]
カラー	color (loan word)
すり	pickpocket
キャンプ	camping, camp
オートバイ	motorbike, motorcycle
建つ	be built, be erected	[たつ]
刺す	sting, stab	[さす]
言い方	way of speaking, expression	[いいかた]
沈む	sink	[しずむ]
組み立てる	set up, put together	[くみたてる]
恐ろしい	terrible, awful	[おそろしい]
外人	foreigner, alien	[がいじん]
牛	cattle, cow	[うし]
食堂	cafeteria, canteen	[しょくどう]
毎年	every year (formal)	[まいねん]
毎週	every week	[まいしゅう]
何度	how many times, how many degrees	[なんど]
なかなか	not easily, not readily (in a negative sentence)
さっき	earlier, only a moment ago
久しぶり	after a long time	[ひさしぶり]
便利	convenience	[べんり]
迷惑	trouble, annoyance	[めいわく]
そんなに	so much
びっくりする	be surprised, be startled (casual)
足りる	suffice, be enough	[たりる]
疲れる	get tired, become fatigued	[つかれる]
ひどい	cruel, awful
全然	(not ) at all	[ぜんぜん]
猫	cat	[ねこ]
デパート	department store (loan word)
トイレ	rest room, lavatory (loan word)
地下鉄	subway	[ちかてつ]
駐車場	parking area, parking lot	[ちゅうしゃじょう]
ぶつかる	hit, bump into
運賃	(passenger) fare	[うんちん]
通学	commuting to school	[つうがく]
見送る	see (someone) off	[みおくる]
泣く	cry, weep	[なく]
レストラン	restaurant
メモ	memo, note
予約	reservation, appointment	[よやく]
番号	assigned number	[ばんごう]
注文	order	[ちゅうもん]
パン	bread
ワイン	wine
材料	material, ingredient	[ざいりょう]
豚肉	pork	[ぶたにく]
焼く	bake, grill	[やく]
匂い	(pleasant) smell, odor	[におい]
付ける	attach, apply, put	[つける]
痩せる	lose weight, become thin	[やせる]
届ける	deliver	[とどける]
間に合う	be in time, suffice	[まにあう]
向く	turn, face	[むく]
強さ	strength	[つよさ]
得意	one's specialty, be good at	[とくい]
塗る	spread on, paint	[ぬる]
投げる	throw	[なげる]
習う	learn, take lessons	[ならう]
注目	attention, notice	[ちゅうもく]
未来	future	[みらい]
箱	box, case	[はこ]
右手	right hand, the right hand side	[みぎて]
左手	left hand	[ひだりて]
プール	pool
ピアノ	piano
光る	shine, emit light, sparkle	[ひかる]
踏む	step on, tread on	[ふむ]
別々	separately	[べつべつ]
ボール	ball
握る	grasp, grip, hold	[にぎる]
真っ赤	deep red	[まっか]
拾う	pick up	[ひろう]
回す	turn, rotate (something)	[まわす]
ノート	notebook (loan word)
辞める	resign, leave (one's job), quit	[やめる]
揺れる	shake, sway	[ゆれる]
立派	fine, elegant, magnificent	[りっぱ]
練習	practice, training	[れんしゅう]
割る	divide, split, break	[わる]
部分	part, section	[ぶぶん]
拭く	wipe, dry	[ふく]
招く	invite	[まねく]
急	urgent, steep	[きゅう]
汚れる	become dirty	[よごれる]
渡る	cross, go across	[わたる]
途中	on the way, half way	[とちゅう]
インタビュー	interview (loan word)
盗む	steal, rob	[ぬすむ]
普段	usual, ordinary	[ふだん]
旅館	Japanese inn	[りょかん]
博物館	museum	[はくぶつかん]
ホーム	platform (for short)
引っ越す	move, relocate	[ひっこす]
荷物	baggage, load	[にもつ]
家賃	rent for a place to live	[やちん]
計画	plan	[けいかく]
廊下	hallway, corridor	[ろうか]
天井	ceiling	[てんじょう]
ベッド	bed
ソファー	sofa, couch
屋根	roof	[やね]
祭り	festival	[まつり]
離婚	divorce	[りこん]
葉	leaf	[は]
ボート	light boat, small craft
燃える	burn, catch on fire	[もえる]
巻く	roll up, wrap	[まく]
プラスチック	plastic
訪れる	go and visit (place)	[おとずれる]
破る	tear, breach	[やぶる]
関係	relation, relationship	[かんけい]
不幸	unhappiness, misfortune	[ふこう]
録音	(sound) recording	[ろくおん]
外国語	foreign language	[がいこくご]
着物	traditional Japanese clothes	[きもの]
牛乳	milk	[ぎゅうにゅう]
救急車	ambulance	[きゅうきゅうしゃ]
果物	fruit	[くだもの]
間違い	mistake, error	[まちがい]
映画館	movie theater	[えいがかん]
怖い	scary, be afraid	[こわい]
鏡	mirror	[かがみ]
草	grass, weed	[くさ]
敬語	polite speech	[けいご]
欠席	absence (from school, a gathering, etc.)	[けっせき]
スイッチ	switch
掃除	cleaning	[そうじ]
畳	straw mat	[たたみ]
速さ	speed	[はやさ]
林	woods, forest	[はやし]
プレゼント	present (loan word)
弁当	boxed lunch	[べんとう]
いつでも	at all times, any time
寂しい	lonely, desolate	[さびしい]
少しも	(not) in the least	[すこしも]
尊敬	respect, esteem	[そんけい]
テニス	tennis
広さ	area, extent	[ひろさ]
読み	reading	[よみ]
我慢	patience, endurance	[がまん]
国籍	nationality, citizenship	[こくせき]
恥ずかしい	embarrassed, ashamed	[はずかしい]
ボタン	button
洋服	(western-style) clothes	[ようふく]
油	oil	[あぶら]
おかしい	funny, comical
余る	remain, be in excess	[あまる]
コート	sports court
正直	honest, upright	[しょうじき]
ドラマ	drama
ビザ	visa
水道	water service, channel	[すいどう]
店員	clerk, salesperson	[てんいん]
電池	battery	[でんち]
ポケット	pocket
握手	handshake	[あくしゅ]
そろそろ	soon, it's about time
ぶどう	grapes
迷う	get lost	[まよう]
見物	sightseeing, visit	[けんぶつ]
知らせる	let know, inform	[しらせる]
神社	Shinto shrine	[じんじゃ]
注射	injection, shot	[ちゅうしゃ]
めったに	rarely, seldom
作文	composition, essay	[さくぶん]
鳴る	sound, ring	[なる]
真面目	serious and sincere	[まじめ]
申し込む	apply, sign up	[もうしこむ]
冷蔵庫	refrigerator	[れいぞうこ]
気に入る	like, become fond of	[きにいる]
クリスマス	Christmas
ネクタイ	tie, necktie
誕生日	birthday	[たんじょうび]
独身	single, unmarried	[どくしん]
苦い	bitter	[にがい]
バイオリン	violin
バッグ	bag
今まで	until now	[いままで]
切符	ticket	[きっぷ]
ゴム	elastic, rubber
少々	a little, a bit	[しょうしょう]
随分	extremely, considerably	[ずいぶん]
引っ張る	pull, drag	[ひっぱる]
焼ける	burn, cook	[やける]
鉛筆	pencil	[えんぴつ]
会話	conversation	[かいわ]
ギター	guitar
茶	tea (plain form)	[ちゃ]
暑さ	heat (of weather)	[あつさ]
胃	stomach	[い]
禁煙	non-smoking	[きんえん]
丸い	round	[まるい]
写る	be taken , come out (in photograph)	[うつる]
喫茶店	coffee shop, café	[きっさてん]
やっぱり	just as I thought, after all
週刊誌	weekly magazine	[しゅうかんし]
棚	shelf, rack	[たな]
震える	tremble, shake	[ふるえる]
磨く	polish, grind, brush	[みがく]
カーテン	curtain
火事	fire, blaze	[かじ]
ナイフ	knife
皆さん	everybody, everyone (polite)	[みなさん]
受ける	receive, take, undergo	[うける]
付く	stick to, cling to	[つく]
私	I (formal)	[わたくし]
結構	quite	[けっこう]
悪口	slander, abuse	[わるくち]
広まる	spread, get around	[ひろまる]
内緒	secrecy, privacy	[ないしょ]
つぶる	close (eyes)
用件	matter, things to be done	[ようけん]
ロマンチック	romantic
貯金	money saved up	[ちょきん]
バイク	motorcycle
預かる	take care of, keep	[あずかる]
オレンジ	orange
噛む	bite, chew	[かむ]
きつい	tight, tough
越える	go over, go across	[こえる]
小包	parcel, package	[こづつみ]
新年	new year	[しんねん]
配達	delivery	[はいたつ]
動物園	zoo	[どうぶつえん]
封筒	envelope	[ふうとう]
危ない	dangerous	[あぶない]
テキスト	text, textbook
ビニール	plastic, vinyl
アルバム	album
水泳	swimming	[すいえい]
混む	be crowded, be congested	[こむ]
スカート	skirt
取れる	come off, be removed	[とれる]
ペン	pen
物	thing, object	[もの]
郵便	mail service, postal mail	[ゆうびん]
割れる	crack, split	[われる]
駅員	station attendant	[えきいん]
おしゃべり	talkative, chatty
緑色	green color	[みどりいろ]
毎朝	every morning	[まいあさ]
曲げる	bend (something)	[まげる]
きっと	surely, certainly
理科	science (school subject)	[りか]
下着	underwear	[したぎ]
太る	grow fat, gain weight	[ふとる]
冷房	air conditioning (cooling)	[れいぼう]
別れる	separate, part	[わかれる]
空く	become available or vacant	[あく]
出掛ける	go out, leave home	[でかける]
毎晩	every evening	[まいばん]
指輪	ring	[ゆびわ]
腐る	rot, go bad	[くさる]
貧乏	poverty, destitution	[びんぼう]
おしゃれ	trendy, fashionable
休憩	break, rest	[きゅうけい]
舌	tongue	[した]
ジュース	juice
ゼロ	zero, none (loan word)
朝刊	morning edition paper	[ちょうかん]
丁寧	polite, careful	[ていねい]
苦手	not good at, be bad at	[にがて]
日	(specific) day, sun, daytime	[ひ]
引っ越し	moving (house)	[ひっこし]
歩道	sidewalk, pavement	[ほどう]
折れる	break, snap	[おれる]
見送り	send-off	[みおくり]
夕刊	evening edition paper	[ゆうかん]
この間	the other day, not so long ago	[このあいだ]
冷える	cool down, get chilled	[ひえる]
ピンク	pink
グラス	glass
毛	hair, down	[け]
黒板	blackboard	[こくばん]
積もる	pile up	[つもる]
半年	half a year	[はんとし]
現在	the present, present time	[げんざい]
利用	utilization, usage	[りよう]
方法	method, procedure	[ほうほう]
中心	center (of a circle, etc.), core	[ちゅうしん]
明らか	clear, obvious	[あきらか]
社長	president (of a company)	[しゃちょう]
ほぼ	almost, nearly
商品	goods, commodities	[しょうひん]
大型	large, large scale	[おおがた]
限る	be limited to	[かぎる]
記録	record, documentation	[きろく]
具体的	concrete, specific	[ぐたいてき]
効果	effect, result	[こうか]
公開	opening (to the public)	[こうかい]
作品	work of art, creation	[さくひん]
迫る	close in on, approach	[せまる]
大会	tournament, event	[たいかい]
背景	background, backdrop	[はいけい]
文字	character, letter, writing	[もじ]
規則	rule, regulation	[きそく]
近所	neighborhood	[きんじょ]
グラフ	chart, graph
首都	capital	[しゅと]
減らす	reduce (something)	[へらす]
隠れる	hide	[かくれる]
美術館	art museum	[びじゅつかん]
ばか	foolish, stupid
暇	free time, spare time	[ひま]
絵葉書	picture postcard	[えはがき]
あんなに	that much, such
行き	going, outbound (flight, train, etc.)	[いき]
通勤	commute	[つうきん]
ちゃんと	correctly, properly
のんびり	in a relaxed manner, leisurely
緊張	tension, strain	[きんちょう]
気付く	notice, realize	[きづく]
物語	story, tale	[ものがたり]
出口	exit	[でぐち]
登る	climb, ascend	[のぼる]
真っ白	pure-white	[まっしろ]
下ろす	bring down, take down	[おろす]
貸し出す	lend, lend out	[かしだす]
サッカー	soccer, football
暖房	heating	[だんぼう]
手袋	gloves	[てぶくろ]
留守	not at home	[るす]
嘘	lie	[うそ]
遠慮	restraint, hold back	[えんりょ]
折る	break (something), fold (something)	[おる]
スープ	soup
バナナ	banana
可哀相	poor, pitiful	[かわいそう]
パトカー	police car
ハンバーガー	hamburger
毛布	blanket	[もうふ]
エスカレーター	escalator
お嬢さん	young lady, daughter	[おじょうさん]
手帳	pocket notebook	[てちょう]
タオル	towel
売店	booth, shop	[ばいてん]
パチンコ	pachinko (Japanese pinball)
謝る	apologize	[あやまる]
ケーキ	cake
天気予報	weather forecast	[てんきよほう]
変	strange, weird	[へん]
一生懸命	hard-working, doing one's best	[いっしょうけんめい]
間違う	make a mistake, be wrong	[まちがう]
事務室	clerk's office, office room	[じむしつ]
スーツ	suit
チケット	ticket (loan word)
チョコレート	chocolate
脱ぐ	take off (clothes)	[ぬぐ]
年賀状	New Year's card	[ねんがじょう]
乗り物	vehicle, transportation	[のりもの]
布団	Japanese-style padded mattress	[ふとん]
役に立つ	be useful, be helpful	[やくにたつ]
破れる	be torn, be ripped up	[やぶれる]
用事	errand, business	[ようじ]
写す	copy, photograph	[うつす]
腕時計	wrist watch	[うでどけい]
贈り物	present, gift	[おくりもの]
チャンネル	channel
冷やす	chill (something), cool down	[ひやす]
片付ける	put in order, clean up	[かたづける]
乾杯	toast, drink (in celebration)	[かんぱい]
停車	stop (of a train)	[ていしゃ]
鳴く	sing, cry (of animals)	[なく]
ガソリンスタンド	gas station
片道	one way (trip)	[かたみち]
交番	police box	[こうばん]
大分	greatly, fairly, highly	[だいぶ]
デート	date, romantic meeting
梅雨	rainy season	[つゆ]
真っ直ぐ	straight	[まっすぐ]
レモン	lemon
上着	outerwear, coat, jacket	[うわぎ]
偉い	great, eminent	[えらい]
書き方	how to write, way of writing	[かきかた]
炊く	cook (rice)	[たく]
チーズ	cheese
ドライブ	drive (loan word)
踏切	railroad crossing	[ふみきり]
ラケット	racket
受付	receptionist, information office	[うけつけ]
怒る	get angry, scold	[おこる]
化粧	makeup	[けしょう]
都合	convenience, availability	[つごう]
ひげ	beard, moustache
本棚	bookshelf, bookcase	[ほんだな]
真っ暗	pitch-dark	[まっくら]
沸く	boil, get loud (crowd applause etc.)	[わく]
売り切れる	sell out, go out of stock	[うりきれる]
押し入れ	sliding-door closet	[おしいれ]
革	leather	[かわ]
ぐっすり	soundly
紅茶	black tea	[こうちゃ]
邪魔	disturbance, blocking	[じゃま]
ソース	sauce
足す	add (things of the same kind)	[たす]
トマト	tomato
バター	butter
発車	departure (of a vehicle)	[はっしゃ]
バレーボール	volleyball
おかず	dishes to go with the rice
カレンダー	calendar
とにかく	in any case, anyway
楽しみ	enjoyment, something looked forward to	[たのしみ]
おしゃべり	chatter, idle talk
読書	reading books	[どくしょ]
寒気	chill	[さむけ]
夕焼け	sunset glow	[ゆうやけ]
痛める	damage, hurt	[いためる]
くすぐったい	ticklish
泥棒	thief, burglar	[どろぼう]
襖	paper sliding door	[ふすま]
美人	beautiful woman	[びじん]
タイプライター	typewriter
再来年	the year after next	[さらいねん]
冗談	joke	[じょうだん]
近づく	approach, come close	[ちかづく]
電話帳	telephone book	[でんわちょう]
ベル	bell
干す	hang (something) out to dry	[ほす]
金額	amount of money, sum	[きんがく]
蚊	mosquito	[か]
悲しむ	feel sad, lament	[かなしむ]
クーラー	air conditioner (cooling)
失礼	rudeness, to excuse oneself	[しつれい]
洗濯機	washing machine, washer	[せんたくき]
豆腐	tofu	[とうふ]
昼寝	nap	[ひるね]
不便	inconvenient	[ふべん]
ミルク	milk (loan word)
向こう側	other side	[むこうがわ]
億	hundred million	[おく]
お礼	thanks, gratitude	[おれい]
着せる	dress (someone)	[きせる]
サラダ	salad
代える	substitute for	[かえる]
四角	square	[しかく]
急行	express train	[きゅうこう]
交差点	crossing, intersection	[こうさてん]
覚める	awake, wake up (naturally)	[さめる]
昼休み	lunch break	[ひるやすみ]
ベルト	belt
真っ黒	black, jet-black	[まっくろ]
皆様	everyone, ladies and gentlemen	[みなさま]
ラーメン	ramen (Chinese noodles)
ライター	lighter
ワイシャツ	business shirt, dress shirt
転ぶ	fall down, fall over	[ころぶ]
シャワー	shower
扇風機	electric fan	[せんぷうき]
遅刻	tardiness, lateness	[ちこく]
釣る	fish, catch	[つる]
うどん	Japanese wheat noodles
仮名	kana	[かな]
記念日	memorial day, anniversary	[きねんび]
下り	going down, going away from a central place	[くだり]
掲示板	notice board, bulletin board	[けいじばん]
凍る	freeze	[こおる]
ごみ	trash
スーパーマーケット	supermarket
ぶらぶら	aimlessly, idly
アナウンサー	announcer
自炊	cooking (for oneself)	[じすい]
止める	stop (something/someone)	[とめる]
年下	younger, junior	[としした]
治す	cure (something)	[なおす]
箸	chopsticks	[はし]
花見	flower viewing	[はなみ]
引き出し	drawer	[ひきだし]
訳	translation	[やく]
いかが	how (polite)
交通費	traveling expense, transportation fee	[こうつうひ]
ステレオ	stereo
再会	meeting again, reunion	[さいかい]
滑る	slide, slip	[すべる]
早口	speaking fast	[はやくち]
裏返す	turn over, turn inside out	[うらがえす]
角	corner, edge	[かど]
きらきら	sparkling, glittering
三角	figure, area etc. with three points or angles, triangle	[さんかく]
激しい	violent, intense	[はげしい]
経営	management, operation	[けいえい]
拡大	magnification, enlargement	[かくだい]
姿勢	posture, position	[しせい]
周辺	area, region	[しゅうへん]
他	other (Chinese origin)	[た]
達する	attain, reach	[たっする]
当時	at that time	[とうじ]
当然	natural, as a matter of course	[とうぜん]
能力	capability, capacity, ability	[のうりょく]
判断	judgment, decision	[はんだん]
過ぎる	pass by, go past	[すぎる]
正確	accurate, precise	[せいかく]
戦争	war between countries	[せんそう]
放送	broadcasting	[ほうそう]
習慣	custom, habit	[しゅうかん]
フィルム	film
受け付ける	receive, accept	[うけつける]
ダンス	dance, dancing (loan word)
こんなに	this much, such
吹く	blow, play (a wind instrument)	[ふく]
まあ	well (interjection)
メール	e-mail
インターネット	Internet
出身	come from, origin	[しゅっしん]
職業	occupation, job	[しょくぎょう]
スター	star
くだらない	worthless, trifling
名簿	name list	[めいぼ]
通常	common, usually, typically	[つうじょう]
家内	one's wife	[かない]
消防署	fire station	[しょうぼうしょ]
再び	again, a second time	[ふたたび]
大統領	president (of a country)	[だいとうりょう]
入場券	entrance ticket	[にゅうじょうけん]
ネックレス	necklace
パジャマ	pajamas
ボールペン	ballpoint pen
かゆい	itchy
覚ます	awaken, wake up	[さます]
すいか	watermelon
そば	buckwheat noodles
特急	super-express, limited express	[とっきゅう]
のり	glue, starch
大抵	generally, mostly	[たいてい]
バスケットボール	basketball
酔っ払う	get drunk	[よっぱらう]
どきどき	thumping, in a pounding manner
欲しがる	want, desire (of the third person)	[ほしがる]
早起き	getting up early	[はやおき]
味噌汁	miso soup	[みそしる]
読み方	how to read, way of reading	[よみかた]
入り口	entrance	[いりぐち]
降ろす	unload, set down	[おろす]
掛かる	hang	[かかる]
サンドイッチ	sandwich
四角い	square-shaped	[しかくい]
突き当たる	run into, come to the end (of a road)	[つきあたる]
乾かす	dry (something)	[かわかす]
定期券	commuter pass	[ていきけん]
にこにこ	smilingly, keep smiling
下る	go down, go away from	[くだる]
ウール	wool
コーラ	cola, coke
トイレットペーパー	toilet paper
乗り換え	transfer, change (trains)	[のりかえ]
灰皿	ashtray	[はいざら]
ハム	ham
床	floor	[ゆか]
ローマ字	Roman alphabet	[ローマじ]
いちご	strawberry
カレーライス	curry rice
キャッシュカード	cash card
停留所	(bus) stop	[ていりゅうじょ]
床屋	barber, barbershop	[とこや]
歯磨き	brushing one's teeth	[はみがき]
夕飯	evening meal, dinner	[ゆうはん]
酔っ払い	drunkard, drunk	[よっぱらい]
例	example	[れい]
お辞儀	bow	[おじぎ]
横断歩道	pedestrian crossing, crosswalk	[おうだんほどう]
ぐらぐら	shaky, unstable
航空便	airmail, airfreight	[こうくうびん]
ジャム	jam
スリッパ	slippers
畳む	fold, shut, close	[たたむ]
トランプ	playing cards
日陰	shade of the sun	[ひかげ]
文房具	stationery, writing materials	[ぶんぼうぐ]
免許証	license	[めんきょしょう]
訳す	translate	[やくす]
よろしい	all right
両替	money exchange	[りょうがえ]
片づく	be put in order, be finished	[かたづく]
カップ	cup
消しゴム	eraser	[けしゴム]
スケート	skate, skates
鍋	pan	[なべ]
寝坊	oversleeping	[ねぼう]
鋏	scissors	[はさみ]
真っ青	deep-blue, pale	[まっさお]
汚す	make (something) dirty	[よごす]
忘れ物	something left behind, lost item	[わすれもの]
掛け算	multiplication	[かけざん]
臭い	stinky	[くさい]
突き当たり	end of a street	[つきあたり]
マフラー	scarf, muffler
桃	peach	[もも]
アクセサリー	accessories, jewelry
あくび	yawn
あめ	candy
上り	going up, ascent	[のぼり]
なるべく	as...as possible, if possible
じっと	without moving, still
食器	tableware	[しょっき]
延ばす	extend, postpone	[のばす]
薬局	drugstore, pharmacy	[やっきょく]
雄	male (animal)	[おす]
雌	female (animal)	[めす]
和風	Japanese-inspired, Japanese-style	[わふう]
いびき	snoring
ピクニック	picnic
地域	region, area	[ちいき]
勘違い	misunderstanding, wrong idea or assumption	[かんちがい]
重要	important, essential	[じゅうよう]
主人	one's husband, master	[しゅじん]
お宅	(someone else's) home	[おたく]
ハイキング	hiking
畑	field, farm	[はたけ]
ボーイフレンド	boyfriend
イヤリング	earrings
ガールフレンド	girlfriend
柔らか	soft, gentle	[やわらか]
納豆	fermented soybeans	[なっとう]
別に	particularly, not really	[べつに]
どうしても	by any means, no matter how
父親	father, male parent	[ちちおや]
誘う	invite, ask out	[さそう]
母親	mother, female parent	[ははおや]
昼前	in the morning, before noon	[ひるまえ]
ふらふら	be dizzy, lightheaded
こぼす	spill (something)
持ってくる	bring	[もってくる]
振り向く	turn around, look back	[ふりむく]
洗面所	washroom, bathroom	[せんめんじょ]
外側	exterior, outside	[そとがわ]
段々	gradually, little by little	[だんだん]
包む	wrap, pack	[つつむ]
無くなる	go missing, run out	[なくなる]
豚	pig	[ぶた]
褒める	praise, compliment	[ほめる]
沸かす	boil (water)	[わかす]
暖める	warm (something) up	[あたためる]
換える	exchange, convert	[かえる]
安っぽい	cheap-looking, tacky	[やすっぽい]
ぎらぎら	glaring, blinding
何とか	somehow or other	[なんとか]
いよいよ	finally, any moment
がらがら	not crowded
缶詰	canned food	[かんづめ]
怪我	injury	[けが]
寒さ	coldness, cold	[さむさ]
祝日	holiday	[しゅくじつ]
すき焼き	sukiyaki	[すきやき]
葉書	postcard	[はがき]
掃く	sweep	[はく]
何しろ	anyhow, as you may know	[なにしろ]
どんどん	quickly, rapidly
ぺこぺこ	hungry, starving
ぺらぺら	fluently, in a chatty way
レインコート	raincoat
アイス	ice cream (for short)
塩辛い	salty	[しおからい]
セロテープ	scotch tape
大幅	drastically, substantially	[おおはば]
教育	education	[きょういく]
工事	construction, repairing	[こうじ]
担当	being in charge (of official duties)	[たんとう]
法律	law	[ほうりつ]
丸	circle, round	[まる]
発表	announcement	[はっぴょう]
研究	research, study	[けんきゅう]
一方	one way, the other party	[いっぽう]
国内	domestic, internal	[こくない]
全体	whole, total	[ぜんたい]
後	after, afterward (formal)	[のち]
人間	human being	[にんげん]
刺身	sliced raw fish or meat	[さしみ]
ばら	rose
ねずみ	rat, mouse
以下	below	[いか]
昔	old times, the old days	[むかし]
訳	reason, sense	[わけ]
違い	difference, mistake	[ちがい]
しっかり	mature, responsible
将来	future, in the future	[しょうらい]
不思議	mystery, wonder	[ふしぎ]
決して	never, by no means	[けっして]
失敗	failure, mistake	[しっぱい]
番	one's turn, watch	[ばん]
出会う	meet, encounter	[であう]
悩む	be troubled, suffer	[なやむ]
汗	sweat	[あせ]
すっかり	all, completely
代わり	substitution, alternative	[かわり]
一言	single word, brief speech	[ひとこと]
豊か	rich, ample	[ゆたか]
接続	connection, joining	[せつぞく]
抱える	hold in one's arms	[かかえる]
エンジン	engine
少女	young girl	[しょうじょ]
無駄	pointless, waste	[むだ]
自動	automatic operation	[じどう]
先輩	senior, superior	[せんぱい]
眺める	look out, gaze	[ながめる]
書類	documents, papers	[しょるい]
年月	years, period of time	[ねんげつ]
燃やす	burn (something)	[もやす]
線路	railway track, line	[せんろ]
水着	bathing suit, swimsuit	[みずぎ]
可愛らしい	lovely, charming	[かわいらしい]
仲良し	good friend	[なかよし]
梅干し	pickled plum	[うめぼし]
ドレス	formal dress
尽くす	make utmost efforts, devote to	[つくす]
地球	the earth	[ちきゅう]
不親切	unkind, inconsiderate	[ふしんせつ]
からから	very thirsty, very dry
本箱	bookcase	[ほんばこ]
横書き	horizontal writing	[よこがき]
そば屋	buckwheat noodle shop	[そばや]
加工	processing, editing (a photo, etc.)	[かこう]
実験	experiment	[じっけん]
愛する	love, care for	[あいする]
あんまり	(not) that much, (not) so much
いきなり	all of a sudden, abruptly
表	front, outside	[おもて]
汚れ	dirt, blot	[よごれ]
間	interval, space between things	[あいだ]
紫	purple	[むらさき]
灰色	ash color, gray	[はいいろ]
血	blood (colloquial)	[ち]
顎	jaw, chin	[あご]
始めに	in the beginning	[はじめに]
暖まる	get warm (air, atmosphere, etc.)	[あたたまる]
お世辞	compliment, flattery	[おせじ]
袋	bag, sack	[ふくろ]
長袖	long sleeves	[ながそで]
半袖	short sleeves	[はんそで]
形	shape, form	[かたち]
景色	natural scenery or landscape	[けしき]
ざあざあ	pouring
再来月	the month after next	[さらいげつ]
泊める	let (someone) stay over	[とめる]
叱る	scold, reprimand	[しかる]
騒ぐ	make a noise, make a racket	[さわぐ]
車道	road, roadway (for cars)	[しゃどう]
掃除機	vacuum cleaner	[そうじき]
剃る	shave	[そる]
貼る	stick, paste, put	[はる]
台	stand, table	[だい]
主に	mostly, predominantly	[おもに]
倒す	knock down, overthrow	[たおす]
星	star, planet	[ほし]
長女	eldest daughter	[ちょうじょ]
爪	nail, claw	[つめ]
缶	can, tin	[かん]
とんとん	tapping, patting
袖	sleeve	[そで]
濡れる	get wet	[ぬれる]
パーセント	percent
上がる	go up, increase (in quality or quantity)	[あがる]
拍手	applause, clapping	[はくしゅ]
弾く	play (instruments)	[ひく]
ひも	laces, string
昼過ぎ	early afternoon	[ひるすぎ]
船	ship, vessel	[ふね]
まく	scatter, sprinkle
姪	niece	[めい]
個人	individual person	[こじん]
歌手	singer	[かしゅ]
社員	staff member, employee	[しゃいん]
不動産屋	real estate agent	[ふどうさんや]
最大	biggest, largest	[さいだい]
動き	movement, motion	[うごき]
事件	affair, incident	[じけん]
過去	the past	[かこ]
協力	cooperation, collaboration	[きょうりょく]
時期	time, season	[じき]
経つ	pass, elapse	[たつ]
雷	thunder, lightning	[かみなり]
責任	responsibility	[せきにん]
願う	wish, desire	[ねがう]
発見	discovery, revelation	[はっけん]
気	spirit, temperament	[き]
美容院	hair salon	[びよういん]
状況	situation, surrounding conditions	[じょうきょう]
目的	objective, purpose	[もくてき]
企業	corporation, business	[きぎょう]
釣り	fishing	[つり]
漫画	comics, cartoon	[まんが]
温泉	hot spring	[おんせん]
トレーニング	training, workout
噂	gossip, rumor	[うわさ]
本物	real, truly worthy (things, people)	[ほんもの]
アイデア	idea (loan word)
地下	underground, basement	[ちか]
マーケット	market
スケジュール	schedule (loan word)
出張	business trip	[しゅっちょう]
コック	cook, chef
正午	noon	[しょうご]
ブラシ	brush
書き取る	write down, note down	[かきとる]
歓迎	welcome, greet	[かんげい]
開発	development	[かいはつ]
郵便屋さん	mail carrier	[ゆうびんやさん]
会長	president, chairperson	[かいちょう]
金	gold	[きん]
灰	ashes	[はい]
骨	bone	[ほね]
風呂屋	bathhouse, public bath	[ふろや]
細か	small, fine, detailed	[こまか]
行き	going, bound for (traditional reading)	[ゆき]
人々	people	[ひとびと]
寺	temple	[てら]
鶏	rooster, hen	[にわとり]
港	port, harbor	[みなと]
移る	move to, transfer to	[うつる]
異なる	differ	[ことなる]
提供	offer, provide	[ていきょう]
市民	citizen	[しみん]
患者	patient	[かんじゃ]
元旦	morning of the January 1st, New Year's Day	[がんたん]
柔らかい	soft, gentle	[やわらかい]
似合う	suit, match well	[にあう]
確かめる	check, confirm	[たしかめる]
背中	(one's) back	[せなか]
肌	human skin, surface	[はだ]
順番	order, turn	[じゅんばん]
まとも	sane, reasonable
ぴったり	exactly right, perfect
思わず	unintentionally, unconsciously, spontaneously	[おもわず]
より	even more ~, even less ~
もったいない	wasteful, a shame
情報	information	[じょうほう]
諦める	abandon, give up	[あきらめる]
懐かしい	fondly-remembered, long-forgotten	[なつかしい]
怪しい	suspicious, dubious	[あやしい]
示す	show, indicate	[しめす]
たっぷり	fully, amply
早速	immediately, right away	[さっそく]
偶然	by chance, coincidence	[ぐうぜん]
続き	continuation, sequel	[つづき]
合計	sum, total	[ごうけい]
傷	wound, scar	[きず]
面倒	troublesome, difficult	[めんどう]
具合	condition, health	[ぐあい]
中止	suspension, cancellation	[ちゅうし]
手続き	procedure, proceeding	[てつづき]
結果	result, outcome	[けっか]
建設	construction	[けんせつ]
販売	sale, selling	[はんばい]
機能	function, feature	[きのう]
頃	time, the time when ~	[ころ]
日中	during the day	[にっちゅう]
今後	in the future, from now on	[こんご]
影響	influence, effect	[えいきょう]
分野	field, area	[ぶんや]
関する	relate to, regarding	[かんする]
状態	state, condition	[じょうたい]
価格	price, value	[かかく]
姿	figure, appearance	[すがた]
期待	expectation, anticipation	[きたい]
除く	remove, exclude	[のぞく]
一般	general, common	[いっぱん]
表現	expression	[ひょうげん]
完成	completion, finish making or building something	[かんせい]
変化	change, alteration	[へんか]
参加	participation	[さんか]
土地	land	[とち]
検討	examination and consideration	[けんとう]
開始	beginning	[かいし]
備える	provide for, prepare for	[そなえる]
内容	content	[ないよう]
与える	give (formal)	[あたえる]
広がる	spread out, extend	[ひろがる]
事実	fact, truth	[じじつ]
決定	decision	[けってい]
住宅	housing, residence	[じゅうたく]
代表	representative	[だいひょう]
命令	command, order	[めいれい]
立場	standpoint, position	[たちば]
なお	still, in addition
計算	calculation	[けいさん]
可能	possible, potential	[かのう]
報告	report	[ほうこく]
都市	city, urban city	[とし]
政治	politics	[せいじ]
競争	competition	[きょうそう]
原因	cause, origin	[げんいん]
活動	activity	[かつどう]
歴史	history	[れきし]
表	table, list	[ひょう]
サイト	website
土産	souvenir (plain)	[みやげ]
臭い	(bad) smell	[におい]
現金	cash	[げんきん]
虫	insect, bug	[むし]
寄る	stop by, stop off	[よる]
田舎	hometown, countryside	[いなか]
帰宅	return home, come home	[きたく]
重大	important, serious	[じゅうだい]
マイナス	minus, below zero
稼ぐ	earn, make money	[かせぐ]
左右	left and right	[さゆう]
痛み	pain, ache	[いたみ]
誤解	misunderstanding	[ごかい]
文句	complaint, grumble	[もんく]
欧米	Europe and America	[おうべい]
面接	interview	[めんせつ]
サイン	signature, autograph
年中	all year	[ねんじゅう]
機嫌	mood, health	[きげん]
居間	living room	[いま]
度々	often	[たびたび]
例文	example sentence	[れいぶん]
怠ける	be lazy, slack off	[なまける]
転勤	change of job location, relocation	[てんきん]
政府	government, administration	[せいふ]
所有	ownership, own	[しょゆう]
いずれ	sometime later, eventually
対する	face, be in response to	[たいする]
教会	church	[きょうかい]
ご存知	know (honorific)	[ごぞんじ]
雀	sparrow	[すずめ]
適当	proper, adequate	[てきとう]
残り	rest, leftover	[のこり]
戻す	put (something) back	[もどす]
体重	body weight	[たいじゅう]
あれこれ	this and that, one thing or another
どうせ	anyway
湖	lake	[みずうみ]
とうとう	finally, in the end
負け	defeat, loss	[まけ]
悔しい	frustrating, regrettable	[くやしい]
姉妹	sisters	[しまい]
助かる	be helped, be rescued	[たすかる]
手前	in front	[てまえ]
さっぱり	completely not
ついで	on the way, to take the opportunity
すっきり	refreshed
とんでもない	unthinkable, outrageous
坂	slope, hill	[さか]
飛び込む	dive into, jump into	[とびこむ]
コメント	comment
書き直す	rewrite	[かきなおす]
看護婦	female nurse	[かんごふ]
就職	finding a job, getting a job	[しゅうしょく]
糸	thread, yarn	[いと]
売り場	sales floor, department	[うりば]
校長	principal, schoolmaster	[こうちょう]
見学	field trip	[けんがく]
進学	advance to higher education	[しんがく]
退院	discharge from hospital	[たいいん]
テント	tent
踊り	dance, dancing	[おどり]
植える	plant, sow	[うえる]
幼稚園	kindergarten	[ようちえん]
エアメール	airmail (loanword)
四季	the four seasons	[しき]
ナイロン	nylon
消防車	fire engine	[しょうぼうしゃ]
ハンドバッグ	handbag
農業	agriculture	[のうぎょう]
アイロン	iron (for clothes)
ラッシュアワー	rush hour
速達	special delivery, express delivery	[そくたつ]
予習	preparation, previewing (a lesson)	[よしゅう]
書留	registered mail	[かきとめ]
深さ	depth, profundity	[ふかさ]
ウィスキー	whisk(e)y
シャープペンシル	mechanical pencil
取引	transaction, deal	[とりひき]
設ける	set up, establish	[もうける]
一定	fixed, certain	[いってい]
記者	journalist, reporter	[きしゃ]
基準	standard, criterion	[きじゅん]
傾向	tendency, disposition	[けいこう]
契約	contract, agreement	[けいやく]
産業	industry	[さんぎょう]
事情	circumstances, conditions	[じじょう]
実行	practice, execution	[じっこう]
組織	organization, structure	[そしき]
逮捕	arrest, capture	[たいほ]
程度	degree, extent	[ていど]
同様	similar, the same as	[どうよう]
要求	need, demand	[ようきゅう]
貿易	(export and import) trade	[ぼうえき]
輸出	export	[ゆしゅつ]
商業	commerce, trade	[しょうぎょう]
船便	surface mail, shipping service	[ふなびん]
選挙	election	[せんきょ]
住民	resident	[じゅうみん]
出席	attendance, presence	[しゅっせき]
発言	utterance, remark	[はつげん]
伴う	accompany, entail	[ともなう]
採用	employment, adoption	[さいよう]
処理	handling, processing	[しょり]
解決	solution, settlement	[かいけつ]
全国	the whole country	[ぜんこく]
作業	work, operation	[さぎょう]
生産	production	[せいさん]
管理	management, administration	[かんり]
増加	increase, rise	[ぞうか]
特徴	distinctive feature, characteristic	[とくちょう]
強調	emphasis, stress	[きょうちょう]
制度	system	[せいど]
株	stock, share	[かぶ]
加える	add (things of the same or different kinds)	[くわえる]
強化	strengthening	[きょうか]
設計	design, plan	[せっけい]
段階	stage, phase	[だんかい]
行う	do, carry out	[おこなう]
経済	economy, economics	[けいざい]
工場	factory, plant	[こうじょう]
技術	skill, technology	[ぎじゅつ]
施設	facilities, institution	[しせつ]
神	god (plain)	[かみ]
人口	population	[じんこう]
党	party, faction	[とう]
輸入	import	[ゆにゅう]
煮る	simmer, cook	[にる]
コンサート	concert
ガソリン	gasoline
パンツ	pants, trousers
そっくり	almost identical
名刺	business card, name card	[めいし]
いちいち	every time, about everything
しつこい	persistent, pesky
喉	throat	[のど]
身長	height	[しんちょう]
何で	why, what for	[なんで]
味噌	soybean paste	[みそ]
気の毒	pitiful, poor	[きのどく]
そっと	softly, gently
こっそり	secretly
うっかり	carelessly, accidentally
わざと	on purpose
がっかり	disappointed, disappointing
ぼんやり	vacantly, absent-mindedly
酢	vinegar	[す]
羨ましい	envious, jealous	[うらやましい]
捕まえる	catch, arrest	[つかまえる]
ちっとも	not at all (casual)
親指	thumb	[おやゆび]
通り過ぎる	go past, pass	[とおりすぎる]
屋上	housetop, rooftop	[おくじょう]
蓋	lid, cover	[ふた]
いつの間にか	before noticing it, out of nowhere	[いつのまにか]
象	elephant	[ぞう]
嫌がる	dislike, be unwilling	[いやがる]
わがまま	selfish
徹夜	staying up all night	[てつや]
まあまあ	now now, well well
ふざける	mess around, fool around
一度に	all at once, at a time	[いちどに]
頷く	nod	[うなずく]
改札	ticket gate	[かいさつ]
手伝い	help, assistance	[てつだい]
とっくに	long ago, already
洗剤	detergent	[せんざい]
手首	wrist	[てくび]
日帰り	a day trip	[ひがえり]
取り消す	cancel	[とりけす]
あきれる	be amazed at, be stunned by (something negative)
月末	end of the month	[げつまつ]
咳	cough	[せき]
あいにく	unfortunately, we are afraid that
近寄る	go near, approach	[ちかよる]
うろうろ	in a loafing-about manner, not really knowing what to do
重たい	heavy, serious	[おもたい]
かじる	nibble, bite
長引く	be prolonged, drag on	[ながびく]
せっせと	diligently, hard
横切る	cut across	[よこぎる]
取り替える	change, replace	[とりかえる]
からかう	make fun of, tease
好き嫌い	likes and dislikes, taste	[すききらい]
蒸し暑い	hot and humid	[むしあつい]
支度	preparation, getting ready	[したく]
薄暗い	gloomy, dim	[うすぐらい]
着替え	change of clothes	[きがえ]
ワンピース	one-piece dress
生年月日	year and date of birth	[せいねんがっぴ]
虫歯	cavity	[むしば]
留守番	looking after the house	[るすばん]
張り切る	go all out, be full of energy (to do something)	[はりきる]
意地悪	mean, ill-natured	[いじわる]
生意気	impudent, cocky	[なまいき]
シーツ	bed sheet
フライパン	frying pan
一人一人	each and every person	[ひとりひとり]
話し掛ける	start a conversation, speak to (someone)	[はなしかける]
追い掛ける	chase, run after	[おいかける]
小指	little finger, little toe	[こゆび]
ぴかぴか	shiny, glittering
中指	middle finger, middle toe	[なかゆび]
まぶた	eyelid
面倒臭い	troublesome, tiresome	[めんどうくさい]
ゆでる	boil
できるだけ	as (much) as possible
もしかしたら	possibly, perhaps
いつまでも	forever
まぶしい	dazzling, glaring
おやつ	snack, refreshment
空っぽ	empty	[からっぽ]
ぶつぶつ	in a mutter, mumble
すっと	(feel) refreshed, satisfied
図々しい	impudent, cheeky	[ずうずうしい]
にっこり	smiling brightly
けち	stingy, miser
追いつく	catch up with	[おいつく]
くしゃみ	sneeze
冷ます	let cool	[さます]
だらしない	untidy, sloppy
甘やかす	be indulgent to, spoil	[あまやかす]
いらいら	irritated
薬指	ring finger	[くすりゆび]
のろのろ	slowly, sluggishly
ポイント	point
工業	industry, the manufacturing industry	[こうぎょう]
構造	construction, structure	[こうぞう]
さすが	just as expected, true to reputation
居眠り	doze, catnap	[いねむり]
散らかす	make a mess	[ちらかす]
濡らす	get (something) wet	[ぬらす]
日にち	date (fixed for something)	[ひにち]
いじめる	bully, abuse
足下	step, under foot	[あしもと]
うさぎ	rabbit, hare
紺	dark blue, navy blue	[こん]
目茶苦茶	in a mess, chaotic	[めちゃくちゃ]
立ち入り禁止	no trespassing	[たちいりきんし]
間もなく	soon, in a short time	[まもなく]
通帳	bankbook, passbook	[つうちょう]
しびれる	go numb, fall asleep
ぎっしり	tightly, closely
うがい	gargling
思いつく	think of, hit upon	[おもいつく]
宛名	name of recipient, addressee	[あてな]
戸棚	cupboard	[とだな]
焦げる	be burned, be scorched	[こげる]
かく	scratch
威張る	be arrogant, be boastful	[いばる]
人混み	crowd	[ひとごみ]
ずらり	lining up neatly
思い切り	to one's heart's content, with all one's might	[おもいきり]
青白い	pale	[あおじろい]
しゃがむ	squat down
言葉遣い	wording, language	[ことばづかい]
通り掛かる	happen to pass by	[とおりかかる]
御無沙汰	be out of touch	[ごぶさた]
市場	market (industrial, financial, etc.)	[しじょう]
データ	data
購入	purchase	[こうにゅう]
ビジネス	business
俺	I (masculine sense)	[おれ]
登録	registration	[とうろく]
体験	personal experience	[たいけん]
デザイン	design
負担	burden, charge	[ふたん]
詳細	details, particulars	[しょうさい]
アップ	close-up
終了	end, termination	[しゅうりょう]
ファン	fan, admirer
予想	expectation, forecast	[よそう]
企画	planning, project	[きかく]
財政	public finance, financial affairs	[ざいせい]
総合	integration, put together	[そうごう]
ケース	case
メーカー	maker, manufacturer
治療	medical treatment	[ちりょう]
読者	reader	[どくしゃ]
職員	staff, employee	[しょくいん]
世代	generation	[せだい]
視点	viewpoint, perspective	[してん]
効率	efficiency, performance	[こうりつ]
資産	property, assets	[しさん]
取り組む	work on, tackle	[とりくむ]
ルール	rule (loan word)
資格	qualifications, competence	[しかく]
成果	result	[せいか]
前提	assumption, premise	[ぜんてい]
現地	local, on-site	[げんち]
内部	interior, inner parts	[ないぶ]
所得	income, earnings	[しょとく]
恋愛	romance, relationship	[れんあい]
支持	support	[しじ]
危機	crisis, danger	[きき]
マスコミ	mass media, media
証拠	proof, evidence	[しょうこ]
コーナー	section (of a store etc.), corner
マーク	logo
減少	decrease, decline	[げんしょう]
緊急	urgent, emergency	[きんきゅう]
要望	demand, request	[ようぼう]
ストレス	stress
主催	sponsorship, host	[しゅさい]
ベスト	best
犠牲	sacrifice, loss	[ぎせい]
暴力	violence, force	[ぼうりょく]
赤字	deficit, in the red	[あかじ]
個性	individuality, unique characteristics	[こせい]
作戦	tactic, strategy	[さくせん]
ショック	shock
アンケート	questionnaire
わざわざ	going out of one's way to do something
本気	serious, earnest	[ほんき]
悩み	troubles, worries	[なやみ]
上司	boss	[じょうし]
説得	persuasion	[せっとく]
ブーム	fad, boom
体力	physical strength, stamina	[たいりょく]
ヒント	hint, clue
正常	normal	[せいじょう]
地獄	hell	[じごく]
後悔	regret	[こうかい]
情熱	passion, enthusiasm	[じょうねつ]
驚き	surprise, amazement	[おどろき]
ジャンプ	jump
アルコール	alcohol, alcoholic beverage
いい加減	irresponsible, careless	[いいかげん]
わくわく	feel excited, be thrilled
言い訳	excuse	[いいわけ]
ミュージック	music (loan word)
青春	blossom of youth, adolescence	[せいしゅん]
あっさり	bluntly, easily
焦る	feel pressured, feel hurried	[あせる]
柔軟	pliable, flexible	[じゅうなん]
タレント	celebrity, TV personality
どうにか	somehow
コンテスト	contest, competition
もてる	be popular (esp. with the opposite sex)
デザート	dessert
クイズ	quiz, quiz show
中毒	poisoning, addiction	[ちゅうどく]
ムード	mood
同情	sympathy, compassion	[どうじょう]
学歴	educational background	[がくれき]
好調	good condition	[こうちょう]
アマチュア	amateur
炒める	stir-fry	[いためる]
カメラマン	photographer
問い合わせる	inquire, ask for (information)	[といあわせる]
しょっちゅう	frequently, repeatedly
ロープ	rope (loan word)
ストライキ	strike
パンク	flat tire
コマーシャル	commercial, advertising
チェンジ	change, exchange
待ち合わせ	meeting with someone, appointment	[まちあわせ]
時差	time difference	[じさ]
義理	sense of duty, obligation	[ぎり]
さっと	quickly
左利き	left-handedness	[ひだりきき]
サボる	slack off, ditch	[サボル]
だるい	feel run-down, weary
ポット	pot, thermos
レントゲン	X-rays
心強い	reassuring, heartening	[こころづよい]
無駄遣い	wasteful spending	[むだづかい]
バッジ	badge
眼科	ophthalmology, eye clinic	[がんか]
履歴書	resume, curriculum vitae	[りれきしょ]
インフレーション	inflation
癌	cancer	[がん]
ぺこぺこ	bow, kowtow
嘘つき	liar	[うそつき]
おごる	treat, pay for (someone)
十字路	crossroads	[じゅうじろ]
びっしょり	drenched, soaked
だぶだぶ	baggy, too big
おだてる	flatter
かかと	heel
ほっと	feel relieved
傷つける	hurt (someone), damage (something)	[きずつける]
うつむく	look down, lower one's eyes
前売り券	advance ticket	[まえうりけん]
短期	short-term	[たんき]
舐める	lick	[なめる]
本日	today (formal)	[ほんじつ]
業界	industry, business world	[ぎょうかい]
ネットワーク	network
弁護士	lawyer, attorney	[べんごし]
入力	input, entry	[にゅうりょく]
画面	screen	[がめん]
前回	last time	[ぜんかい]
後半	latter half, second half	[こうはん]
自信	confidence	[じしん]
素敵	lovely, nice	[すてき]
当たり前	no wonder, natural	[あたりまえ]
やり方	way of doing	[やりかた]
わずか	meager, marginal
ついに	at last, at length
次回	next time	[じかい]
スピード	speed (loan word)
バイト	part-time job (for short)
不可能	impossible	[ふかのう]
アドバイス	advice
落ち着く	calm down, settle in	[おちつく]
せっかく	with much trouble
つい	inadvertently, carelessly
大手	major company	[おおて]
部長	department head	[ぶちょう]
前半	first half	[ぜんはん]
たまたま	by chance, accidentally
相変わらず	as usual, as before	[あいかわらず]
支払い	payment	[しはらい]
人数	number of people	[にんずう]
課長	section chief	[かちょう]
ファッション	fashion
体調	health condition	[たいちょう]
付き合う	socialize with, see (someone)	[つきあう]
ショッピング	shopping
あり	ant
最悪	worst	[さいあく]
かえる	frog
おじさん	Mister, middle-aged man
得	advantage, gain	[とく]
掴む	grip, grab	[つかむ]
知り合い	acquaintance (colloquial)	[しりあい]
ペース	pace
作成	to produce, to make	[さくせい]
親子	parent and child	[おやこ]
話し合い	talk, discussion	[はなしあい]
本社	head office of a company	[ほんしゃ]
打ち合わせ	meeting, arrangement	[うちあわせ]
見守る	watch, keep watch over	[みまもる]
売り上げ	sales, proceeds	[うりあげ]
かえって	rather, instead
アイドル	idol
何となく	for some reason	[なんとなく]
年末	end of year	[ねんまつ]
無意識	unconsciously, unintentionally	[むいしき]
駅前	in front of the station	[えきまえ]
やって来る	come all the way	[やってくる]
キッチン	kitchen (loan word)
キス	kiss
慌てる	be flustered, be in a hurry	[あわてる]
都内	in the metropolitan area of Tokyo	[とない]
残業	overtime work	[ざんぎょう]
曖昧	ambiguous, vague	[あいまい]
カタログ	catalogue
殴る	hit, punch	[なぐる]
両手	both hands	[りょうて]
仲良く	harmoniously, getting along	[なかよく]
始め	beginning, initial part	[はじめ]
知り合う	get acquainted with, get to know (someone)	[しりあう]
お手伝い	help, assistance (polite)	[おてつだい]
マナー	manners
カラオケ	karaoke
二度と	never again	[にどと]
おばさん	middle-aged woman
片手	one hand	[かたて]
保育園	day-care center, nursery school	[ほいくえん]
ずれる	go off track, go out of line
ビーチ	beach
せいぜい	at most, at best
後期	latter term, second half	[こうき]
エアコン	air-conditioning, air conditioner
ゆったり	comfortable, easy fit
ハードウェア	hardware
リクエスト	request (loan word)
翌年	the following year	[よくねん]
キャンセル	cancellation (loan word)
車内	inside a vehicle or a train	[しゃない]
大声	loud voice	[おおごえ]
無責任	irresponsible	[むせきにん]
片方	one side, the other one	[かたほう]
ボリューム	volume
前方	front, ahead	[ぜんぽう]
日本酒	Japanese rice wine	[にほんしゅ]
青空	blue sky	[あおぞら]
不自然	unnatural, artificial	[ふしぜん]
昨晩	last night, last evening (formal)	[さくばん]
市役所	municipal office, city hall	[しやくしょ]
フルーツ	fruit (loan word)
年々	year by year	[ねんねん]
後方	back, rear	[こうほう]
お詫び	apologize, apology	[おわび]
大根	oriental radish	[だいこん]
むく	peel (something)
例年	typical year, average year	[れいねん]
締め切り	deadline	[しめきり]
正に	just, surely	[まさに]
蛇	snake	[へび]
ラッシュ	rush, rush hour
大げさ	exaggerated	[おおげさ]
無理やり	forcibly, against one's will	[むりやり]
外食	eating out, dining out	[がいしょく]
キャベツ	cabbage
手足	hands and feet, limbs	[てあし]
閉店	shop closing	[へいてん]
百貨店	department store	[ひゃっかてん]
クッキー	cookie
車椅子	wheelchair	[くるまいす]
大雨	heavy rain	[おおあめ]
鳩	pigeon, dove	[はと]
中級	middle-class, intermediate	[ちゅうきゅう]
おにぎり	rice ball
ひょっとしたら	perhaps
ぐるぐる	round and round
和食	Japanese-style food	[わしょく]
どく	get out of the way, step aside
ウエスト	waist
忘年会	year-end party	[ぼうねんかい]
包丁	kitchen knife	[ほうちょう]
ゴールデンウィーク	golden week
シューズ	shoes (loan word)
未成年	minor, underage	[みせいねん]
甥	nephew	[おい]
葉っぱ	leaf (colloquial)	[はっぱ]
やり直す	do over again	[やりなおす]
大晦日	new year's eve	[おおみそか]
サングラス	sunglasses
病人	sick person	[びょうにん]
顔色	complexion, facial expression	[かおいろ]
金色	golden color	[きんいろ]
にらむ	glare, stare
つかまる	hold on to (something)
足首	ankle	[あしくび]
散らかる	be in a mess, lie scattered	[ちらかる]
上がる	get nervous	[あがる]
かぼちゃ	pumpkin
水族館	aquarium	[すいぞくかん]
品切れ	sold out	[しなぎれ]
腫れる	swell up, be swollen	[はれる]
やり直し	doing over, redoing	[やりなおし]
バーゲン	bargain sale
男らしい	manly, masculine	[おとこらしい]
近道	shortcut	[ちかみち]
トースト	toast
好奇心	curiosity	[こうきしん]
実用的	practical	[じつようてき]
客観的	objective	[きゃっかんてき]
抽象的	abstract	[ちゅうしょうてき]
送別会	farewell party	[そうべつかい]
敷金	deposit, security deposit	[しききん]
日米	Japan and the U.S.	[にちべい]
専門家	specialist, expert	[せんもんか]
ホット	hot
わさび	Japanese horseradish
初詣	first shrine visit of the new year	[はつもうで]
ジョギング	jogging
社会人	working member of society	[しゃかいじん]
大急ぎ	in a great hurry	[おおいそぎ]
セルフサービス	self-service
くしゃくしゃ	messy, crumpled
食パン	bread in a rectangular shape	[しょくパン]
人差し指	index finger, forefinger	[ひとさしゆび]
洋食	Western food	[ようしょく]
じめじめ	damp
じろじろ	staringly
つるつる	smooth, slippery
こしょう	pepper
びしょびしょ	soaking wet, soaked
ぎゅうぎゅう	packed, crammed
バツ	cross, x-mark (on errors, mistakes etc.)
水色	light blue	[みずいろ]
領収書	bill of receipt (for payment only)	[りょうしゅうしょ]
自然に	naturally	[しぜんに]
とんかつ	pork cutlet
ねぎ	spring onion, green onion
きゅうり	cucumber
鰻	eel	[うなぎ]
まぐろ	tuna
パイナップル	pineapple
ほうれん草	spinach	[ほうれんそう]
マヨネーズ	mayonnaise
玉ねぎ	onion	[たまねぎ]
焼き肉	grilled meat, barbecued meat	[やきにく]
目薬	eye drops	[めぐすり]
寝過ごす	oversleep	[ねすごす]
国際的	international	[こくさいてき]
国際化	internationalization	[こくさいか]
区役所	ward office	[くやくしょ]
和室	Japanese-style room	[わしつ]
本格的	authentic, serious	[ほんかくてき]
高速道路	freeway, expressway	[こうそくどうろ]
とりあえず	for now, for the time being
先に	before, ahead	[さきに]
ぎりぎり	just in time, barely
慌ただしい	busy and hurried	[あわただしい]
今ごろ	by now, at this time	[いまごろ]
くっつく	stick, be attached
北風	north wind	[きたかぜ]
海老	shrimp	[えび]
思い切って	daringly, taking the plunge	[おもいきって]
はっと	taken aback, startled
宛先	recipient's address	[あてさき]
ばらばら	separately, discretely
乗車券	train ticket, bus ticket	[じょうしゃけん]
ぶるぶる	shivering, trembling
すらすら	smoothly, easily
終電	last train	[しゅうでん]
ずるい	cunning, sneaky
すやすや	(sleep) peacefully, soundly
がたがた	with a rattling noise, unstable
非常口	emergency exit	[ひじょうぐち]
ざらざら	rough, gritty
ぬるぬる	slimy
女らしい	womanly, feminine	[おんならしい]
急用	urgent business	[きゅうよう]
きょろきょろ	look around
ぐずぐず	slowly, tardily
ぽかぽか	pleasantly warm
洗い物	dishes to be washed	[あらいもの]
かっと	in a temper, in a rage
どきっと	surprised, shocked
乗り遅れる	miss (a train, bus, etc.)	[のりおくれる]
くたくた	exhausted
すべすべ	smooth, silky
にやにや	grin to oneself
あだ名	nickname	[あだな]
後片付け	cleaning up	[あとかたづけ]
イカ	squid
可愛がる	love, cherish	[かわいがる]
うきうき	excitedly
餃子	Chinese dumpling	[ぎょうざ]
げらげら	(laugh) out loud
ごめん	sorry
明々後日	three days from today	[しあさって]
削減	cutdown, reduction	[さくげん]
贅沢	luxury, extravagance	[ぜいたく]
そのうち	before long, sooner or later
でこぼこ	unevenness, bumpiness
手のひら	palm	[てのひら]
裸足	bare feet	[はだし]
べたべた	stick together, sticky
眉毛	eyebrows	[まゆげ]
割り箸	disposable chopsticks	[わりばし]
日付け	date (written in a document, etc.)	[ひづけ]
ぴたりと	suddenly, coming to a dead stop
まな板	chopping board	[まないた]
筆記用具	pens and pencils, writing materials	[ひっきようぐ]
くすぐる	tickle
かんかん	furiously angry, in a rage
白線	white (warning) line	[はくせん]
見覚え	recognition, remembrance	[みおぼえ]
これまで	until now, until here
からす	crow, raven
噛みつく	bite	[かみつく]
白菜	Chinese cabbage	[はくさい]
プロ野球	professional baseball	[プロやきゅう]
かみそり	razor
何十	several tens	[なんじゅう]
何百	several hundred, hundreds	[なんびゃく]
何千	several thousand, thousands	[なんぜん]
がくんと	sharply, significantly
飛び下りる	jump off, jump down	[とびおりる]
通行止め	road closed	[つうこうどめ]
行き止まり	dead end	[いきどまり]
真ん丸	perfect circle, perfectly round	[まんまる]
いつの間に	without anyone noticing	[いつのまに]
くっ付ける	attach (something), stick (something)	[くっつける]
付け足す	add on, append	[つけたす]
得する	profitable, beneficial	[とくする]
損する	lose, suffer loss	[そんする]
言い返す	talk back	[いいかえす]
体温計	(clinical) thermometer	[たいおんけい]
後戻り	turning back, retreat	[あともどり]
話し声	talking voice	[はなしごえ]
くるくる	round and round, spin
怖がる	be afraid of, fear	[こわがる]
人違い	mistaken identity	[ひとちがい]
取り返す	take back, regain	[とりかえす]
乗り降り	getting on and off	[のりおり]
口喧嘩	quarrel	[くちげんか]
起き上がる	get up, rise	[おきあがる]
ぶら下がる	hang down, dangle	[ぶらさがる]
飛び上がる	fly up, jump up	[とびあがる]
泣き声	tearful voice, sound of crying	[なきごえ]
持ち物	one's belongings	[もちもの]
細長い	long and thin, long and narrow	[ほそながい]
出入り口	doorway, gateway	[でいりぐち]
正座	sitting on one's heels	[せいざ]
大喜び	great joy	[おおよろこび]
落とし物	lost property	[おとしもの]
じゃんじゃん	many times, repeatedly
見違える	look completely different	[みちがえる]
合理的	rational, logical	[ごうりてき]
自主的	voluntary, independent	[じしゅてき]
円高	strong yen	[えんだか]
全面的	full-scale, complete	[ぜんめんてき]
消費者	consumer	[しょうひしゃ]
日中	Japan and China	[にっちゅう]
明日	tomorrow (rather formal)	[あす]
結構	all right, no thank you	[けっこう]
辛い	hard, painstaking	[つらい]
まずい	problematic, troublesome
上下	top and bottom	[じょうげ]
生	raw, fresh	[なま]
よける	avoid, dodge
がやがや	noisily, loudly
赤ん坊	(human) baby	[あかんぼう]
ワープロ	word processor
新聞社	newspaper publisher	[しんぶんしゃ]
寝かす	put (someone) to bed	[ねかす]
者	person (humble)	[もの]
中	middle, medium size	[ちゅう]
性	gender, sexual activities	[せい]
会	meeting, association	[かい]
事	thing, incident	[こと]
今日	these days	[こんにち]
点	point (of concern), dot	[てん]
バック	back, reverse
記事	article, story	[きじ]
大	big, large size	[だい]
法	law, rule	[ほう]
非常	emergency	[ひじょう]
ただ	simply, merely
感じ	feeling, impression	[かんじ]
環境	environment, surroundings	[かんきょう]
理解	understanding, comprehension	[りかい]
県	prefecture	[けん]
使用	use	[しよう]
主義	principle, -ism	[しゅぎ]
国民	citizen	[こくみん]
下	under (someone's) supervision	[もと]
場	occasion, situation	[ば]
労働	labor, work	[ろうどう]
機会	opportunity, chance	[きかい]
製品	product, manufactured goods	[せいひん]
自身	self	[じしん]
かかる	catch (a cold, etc.), come down with
求める	seek, yearn for	[もとめる]
下さる	give (honorific)	[くださる]
昨日	yesterday (formal)	[さくじつ]
元	origin, former	[もと]
型	type, model	[かた]
それぞれ	each, respectively
地方	local region	[ちほう]
面	surface, side	[めん]
実は	actually	[じつは]
夜	night, evening	[よ]
地	ground, place	[ち]
議論	discussion, debate	[ぎろん]
以前	before, ago	[いぜん]
専門	specialty, profession	[せんもん]
申し上げる	tell, say (humble)	[もうしあげる]
行動	action, conduct	[こうどう]
率	ratio, rate	[りつ]
監督	supervisor, film director	[かんとく]
意識	consciousness, awareness	[いしき]
認める	recognize, permit	[みとめる]
参考	reference, consultation	[さんこう]
チーム	team
現実	reality	[げんじつ]
価値	value, worth	[かち]
テーマ	theme, subject matter
含む	contain, include	[ふくむ]
際	opportunity, time	[さい]
全て	all, everything	[すべて]
大臣	minister	[だいじん]
国家	state, nation	[こっか]
試合	match, game	[しあい]
結局	after all, finally	[けっきょく]
消費	consumption, spending	[しょうひ]
人生	one's life (to lead)	[じんせい]
量	quantity, amount	[りょう]
精神	mind, mentality	[せいしん]
レベル	level
我々	we (literary)	[われわれ]
指導	guide, instruction	[しどう]
明日	tomorrow (very formal)	[みょうにち]
資料	materials, data	[しりょう]
団体	group, organization	[だんたい]
最も	the most	[もっとも]
完全	perfect, complete	[かんぜん]
品	goods, item	[しな]
男性	male, man	[だんせい]
軍	military	[ぐん]
描く	depict, draw	[えがく]
最終	final, last (of something repeated)	[さいしゅう]
センター	center (for an activity, etc.), hub
障害	obstacle, disorder	[しょうがい]
医療	medical service, healthcare	[いりょう]
頂く	receive, eat (humble)	[いただく]
金融	finance	[きんゆう]
学ぶ	learn, study	[まなぶ]
成長	growth	[せいちょう]
登場	appearance (on stage, etc.)	[とうじょう]
知識	knowledge	[ちしき]
友人	friend (formal)	[ゆうじん]
イメージ	image
トップ	top, the best
税	tax	[ぜい]
変更	alteration, change	[へんこう]
限り	limit	[かぎり]
式	ceremony	[しき]
展開	development, storyline (plot)	[てんかい]
興味	interest	[きょうみ]
含める	include	[ふくめる]
編集	editing	[へんしゅう]
選択	selection, choice	[せんたく]
無料	no charge, free	[むりょう]
身	body, oneself, one's status	[み]
分析	analysis	[ぶんせき]
予算	budget	[よさん]
目標	target, goal	[もくひょう]
通信	correspondence, communication	[つうしん]
向ける	turn toward, point at	[むける]
時刻	time (formal)	[じこく]
逆	reverse, opposite	[ぎゃく]
最高	supreme, best	[さいこう]
利益	profit, benefit	[りえき]
事務	office work, business	[じむ]
出版	publishing, publication	[しゅっぱん]
プロ	professional
様々	various, diverse	[さまざま]
州	state, province	[しゅう]
共通	commonality	[きょうつう]
現代	present age, modern times	[げんだい]
被害	damage, harm	[ひがい]
新た	new, fresh	[あらた]
相当	suitability, equivalence	[そうとう]
更新	renewal, update	[こうしん]
得る	obtain, gain	[える]
内	inside	[うち]
維持	maintenance, upkeep	[いじ]
料金	charge, fee (for using facilities, etc.)	[りょうきん]
到着	arrival	[とうちゃく]
なま物	uncooked food	[なまもの]
章	chapter	[しょう]
メンバー	member
演奏	musical performance	[えんそう]
案	plan, idea	[あん]
希望	hope, wish	[きぼう]
記憶	memory, remembrance	[きおく]
モデル	model
方々	people (polite)	[かたがた]
発売	launch, release (of a product)	[はつばい]
話題	topic of conversation, being talked about	[わだい]
目指す	aim for	[めざす]
建築	construction, architecture	[けんちく]
印象	impression	[いんしょう]
権利	right, privilege	[けんり]
学習	study, learning	[がくしゅう]
発展	development, expansion	[はってん]
現場	scene, job site	[げんば]
気分	feeling, mood	[きぶん]
移動	movement, shift	[いどう]
発行	publication, issue	[はっこう]
宗教	religion	[しゅうきょう]
改正	revision, amendment	[かいせい]
倍	double, times	[ばい]
不安	uneasy, worried	[ふあん]
自ら	(for) oneself, personally	[みずから]
広告	advertisement	[こうこく]
共同	joint, cooperation	[きょうどう]
年代	generation, era	[ねんだい]
タイプ	type
差	difference	[さ]
営業	business, sales	[えいぎょう]
役割	role, duty, responsibility	[やくわり]
改善	improvement	[かいぜん]
撮影	photographing, shoot	[さつえい]
エネルギー	energy
憲法	constitution, constitutional law	[けんぽう]
感謝	gratitude, thanks	[かんしゃ]
感覚	sense, feel	[かんかく]
旅	journey, travel	[たび]
合わせる	match (something), adapt (oneself)	[あわせる]
既に	already	[すでに]
現状	current condition, situation	[げんじょう]
先日	the other day, a few days ago	[せんじつ]
中央	center, middle	[ちゅうおう]
似る	resemble, be alike	[にる]
平均	average	[へいきん]
末	the end, in the end	[すえ]
追加	addition, supplement	[ついか]
なさる	do (honorific)
様子	the state of affairs, how someone appears	[ようす]
活用	practical use, application	[かつよう]
交換	exchange, bartering	[こうかん]
整備	maintenance	[せいび]
想像	imagination	[そうぞう]
ああ	like that, that much
満足	satisfaction, contentment	[まんぞく]
以降	thereafter, later than	[いこう]
比較	comparison	[ひかく]
クラス	class, category
犯罪	offense, crime	[はんざい]
おっしゃる	say, tell (honorific)
特定	specifying, identifying	[とくてい]
基礎	base, foundation	[きそ]
流れ	flow, stream	[ながれ]
どうも	for no special reason, somehow
村	village	[むら]
安定	stability, composure	[あんてい]
本人	the person himself, the said person	[ほんにん]
雰囲気	atmosphere, mood	[ふんいき]
会場	venue, site	[かいじょう]
電子	electron, electronic	[でんし]
文	sentence	[ぶん]
範囲	range, scope	[はんい]
失う	lose, miss	[うしなう]
常に	always, at all times (formal)	[つねに]
日常	everyday life, daily life	[にちじょう]
回答	reply, answer	[かいとう]
体制	system, structure	[たいせい]
調整	regulation, adjustment	[ちょうせい]
疑問	question, doubt	[ぎもん]
応援	support, cheering	[おうえん]
感想	thought, impression	[かんそう]
解説	explanation, commentary	[かいせつ]
シリーズ	series
公共	public, community	[こうきょう]
民間	private, civilian	[みんかん]
裁判	trial, judgment	[さいばん]
組合	union, guild	[くみあい]
本来	originally, primarily	[ほんらい]
一体	what on earth	[いったい]
宇宙	universe, space	[うちゅう]
申す	say, tell (humble)	[もうす]
図	figure, diagram	[ず]
クラブ	club
観光	sightseeing	[かんこう]
提出	presentation, submission (of a report, plan, etc)	[ていしゅつ]
以来	since then	[いらい]
離れる	get away from	[はなれる]
生	life, living	[せい]
性格	character, personality	[せいかく]
検査	inspection, examination	[けんさ]
信頼	reliance, trust	[しんらい]
人物	character, person	[じんぶつ]
触れる	touch, come in contact with	[ふれる]
記念	commemoration, memory	[きねん]
役	role, part	[やく]
費用	expense, cost	[ひよう]
指定	designation, appointment	[してい]
感情	feeling, emotion	[かんじょう]
空	emptiness, hollow	[から]
関わる	be involved, be concerned	[かかわる]
仲間	comrade, peer	[なかま]
整理	putting something in order, sorting out	[せいり]
至る	come to, reach	[いたる]
独立	independence, self-reliance	[どくりつ]
賞	prize, award	[しょう]
誕生	birth	[たんじょう]
いらっしゃる	come, go (honorific)
都	metropolis of Tokyo	[と]
全員	all members, entire staff	[ぜんいん]
少なくとも	at least, at a minimum	[すくなくとも]
明確	clear and specific	[めいかく]
セット	set
魅力	charm, attraction	[みりょく]
きちんと	properly, neatly
手段	means, way	[しゅだん]
有効	effective, valid	[ゆうこう]
集中	concentration, convergence	[しゅうちゅう]
現象	phenomenon	[げんしょう]
感動	to be impressed, to be touched	[かんどう]
禁止	prohibition, forbiddance	[きんし]
会員	member (of an association, society, etc.)	[かいいん]
過ごす	spend (time)	[すごす]
納得	to fully understand and accept	[なっとく]
収入	income	[しゅうにゅう]
レポート	report, paper
年齢	age	[ねんれい]
舞台	stage, setting	[ぶたい]
交通	traffic, transportation	[こうつう]
他人	other people, stranger	[たにん]
組	school class, group, pair	[くみ]
否定	denial, negation	[ひてい]
扱う	handle, deal with	[あつかう]
修正	correction, revision	[しゅうせい]
一応	tentatively, just in case	[いちおう]
生じる	happen, occur	[しょうじる]
訪問	visit	[ほうもん]
引用	quotation, citation	[いんよう]
芸術	art, arts and crafts	[げいじゅつ]
解釈	interpretation, explanation	[かいしゃく]
行	line, row	[ぎょう]
結論	conclusion	[けつろん]
困難	difficulty, hardship	[こんなん]
回復	recovery, recuperation	[かいふく]
適用	application, coverage	[てきよう]
集団	group, mass	[しゅうだん]
事態	situation, state of affairs	[じたい]
スタート	start, begin (loan word)
更に	furthermore, still more	[さらに]
活躍	(successful) performance, action	[かつやく]
命	life (colloquial)	[いのち]
医師	doctor, physician (formal)	[いし]
おる	be present, stay (humble)
現れる	appear, emerge	[あらわれる]
講演	lecture, talk	[こうえん]
瞬間	moment	[しゅんかん]
交流	interaction, contact	[こうりゅう]
標準	standard, norm	[ひょうじゅん]
まるで	just like
スタイル	style, physique
関心	concern, interest	[かんしん]
取り上げる	take, confiscate	[とりあげる]
伝統	tradition	[でんとう]
民主	democracy	[みんしゅ]
制限	restriction, limit	[せいげん]
投票	vote, ballot	[とうひょう]
心理	mentality, psychology	[しんり]
大体	about, anyway	[だいたい]
突然	suddenly	[とつぜん]
思想	thought, conception	[しそう]
応じる	answer, comply with	[おうじる]
不足	lack, shortage	[ふそく]
コード	cord
世の中	the world, society	[よのなか]
項目	item, topic	[こうもく]
旧	old, former	[きゅう]
次第	as soon as	[しだい]
長期	long period	[ちょうき]
著者	author, writer	[ちょしゃ]
罪	crime, sin	[つみ]
楽	comfortable, easy	[らく]
操作	operation, manipulation	[そうさ]
支配	control, rule	[しはい]
態度	attitude	[たいど]
過程	process, course	[かてい]
バランス	balance
連続	continuation, series	[れんぞく]
機関	agency, facility	[きかん]
論	argument, theory	[ろん]
島	island (Chinese origin)	[とう]
望む	hope	[のぞむ]
単純	simple, uncomplicated	[たんじゅん]
翻訳	translation (of texts)	[ほんやく]
論文	thesis, paper	[ろんぶん]
継続	continuation, succession	[けいぞく]
生命	life (formal)	[せいめい]
敵	enemy, foe	[てき]
単位	unit, credit	[たんい]
複数	plural, multiple	[ふくすう]
確実	certain, sure	[かくじつ]
低	low	[てい]
募集	recruitment, collection	[ぼしゅう]
級	grade, class	[きゅう]
証明	proof, demonstration	[しょうめい]
単に	simply, just	[たんに]
適切	appropriate, adequate	[てきせつ]
財産	fortune, asset	[ざいさん]
作家	writer, novelist	[さっか]
ようやく	at last, at long last
形式	form, format	[けいしき]
違反	violation, breach	[いはん]
義務	duty, obligation	[ぎむ]
公式	official	[こうしき]
場面	scene, situation	[ばめん]
流す	run (water etc.), shed	[ながす]
質	quality	[しつ]
終える	finish (something), complete (something)	[おえる]
会計	accounting, payment (for goods and services)	[かいけい]
開ける	develop, open up	[ひらける]
資源	resources	[しげん]
支える	support, sustain	[ささえる]
成立	formation, closing (of a deal etc.)	[せいりつ]
訓練	training, drill	[くんれん]
食品	food, food product	[しょくひん]
物質	matter, substance	[ぶっしつ]
実に	truly, surely	[じつに]
保存	saving, preservation	[ほぞん]
相互	mutual, reciprocal	[そうご]
依頼	request	[いらい]
差別	discrimination	[さべつ]
設備	equipment, facilities	[せつび]
伺う	ask, hear (humble)	[うかがう]
保証	guarantee, warranty	[ほしょう]
防止	prevention	[ぼうし]
需要	demand	[じゅよう]
無視	ignoring, disregarding	[むし]
生物	living creature, organism	[せいぶつ]
改めて	once again, anew	[あらためて]
優勝	championship	[ゆうしょう]
承知	consent, acknowledgment	[しょうち]
供給	supply, provision	[きょうきゅう]
許可	permission, approval	[きょか]
多少	somewhat, to some extent	[たしょう]
外交	diplomacy, foreign relations	[がいこう]
出来事	occurrence, incident	[できごと]
お互い	each other (polite)	[おたがい]
申請	application, petition	[しんせい]
取れる	come off, get removed, get picked	[とれる]
高速	high speed, express	[こうそく]
特殊	special, unique	[とくしゅ]
文学	literature	[ぶんがく]
議会	assembly, council	[ぎかい]
削除	deletion, elimination	[さくじょ]
高める	heighten (something), improve	[たかめる]
本部	headquarters of an organization	[ほんぶ]
きっかけ	chance, opportunity, impetus
学者	scholar	[がくしゃ]
風景	view, scene	[ふうけい]
それほど	so much, that much
追う	chase, pursue	[おう]
考慮	consideration, deliberation	[こうりょ]
伝わる	be transmitted, come from	[つたわる]
実感	true sense, realization	[じっかん]
近代	modern times	[きんだい]
航空	aviation	[こうくう]
一時	temporarily	[いちじ]
分類	classification	[ぶんるい]
哲学	philosophy	[てつがく]
巨大	huge, gigantic	[きょだい]
表す	express (something)	[あらわす]
人類	humankind	[じんるい]
パターン	pattern
波	wave, fluctuations	[なみ]
低下	falling, lowering	[ていか]
よう	look like, seem
年寄り	elderly people, seniors	[としより]
ロボット	robot
人形	doll	[にんぎょう]
追い越す	outrun, overtake	[おいこす]
インク	ink
言語	language	[げんご]
製造	production, manufacturing	[せいぞう]
西暦	Christian Era, A.D.	[せいれき]
ピンポン	table tennis
訴える	sue, appeal to	[うったえる]
関連	relation, relevance	[かんれん]
述べる	state, remark	[のべる]
批判	criticism	[ひはん]
基づく	be based on	[もとづく]
戦う	wage war, fight	[たたかう]
死亡	death of a person	[しぼう]
載る	appear in print, be published	[のる]
抱く	embrace, have a dream	[いだく]
説	theory, opinion	[せつ]
理想	ideal	[りそう]
受験	take an examination	[じゅけん]
観察	observation	[かんさつ]
税金	tax, tax charge	[ぜいきん]
異常	abnormal, abnormality	[いじょう]
無事	safely, peacefully	[ぶじ]
統計	statistics, figures	[とうけい]
周囲	circumference, surroundings	[しゅうい]
見事	splendid, admirable	[みごと]
児童	(school) children	[じどう]
前後	around, order	[ぜんご]
やや	slightly, a little
女子	woman, girl	[じょし]
常識	common sense, common knowledge	[じょうしき]
博士	expert, master	[はかせ]
余裕	room, leeway (time, money etc.)	[よゆう]
水準	level, standard	[すいじゅん]
講師	lecturer, instructor	[こうし]
物価	prices	[ぶっか]
統一	unity, standardization	[とういつ]
暮らす	live, lead a life	[くらす]
致す	do (humble)	[いたす]
苦労	hardship, suffering	[くろう]
停止	stop, suspension	[ていし]
食う	eat (casual)	[くう]
隠す	hide, conceal	[かくす]
化学	chemistry	[かがく]
信用	trust, credit	[しんよう]
優れる	be superior to, be excellent	[すぐれる]
高度	high degree	[こうど]
宣伝	publicity, advertisement	[せんでん]
支払う	pay (money)	[しはらう]
主要	major, principal	[しゅよう]
謎	puzzle, mystery	[なぞ]
物理	physics	[ぶつり]
恋	love, romance	[こい]
笑顔	smiling face, smile	[えがお]
動作	movement, action	[どうさ]
通じる	pass, communicate with	[つうじる]
反省	reflection of one's past conduct, repentance	[はんせい]
中身	content, interior	[なかみ]
製作	manufacture, production	[せいさく]
診断	diagnosis	[しんだん]
試す	try, test	[ためす]
ますます	increasingly, more and more
去る	go away, leave	[さる]
国立	national	[こくりつ]
計	total (usually used before a number)	[けい]
喜び	joy, delight	[よろこび]
石油	petroleum oil	[せきゆ]
調子	tone, condition	[ちょうし]
単語	word	[たんご]
表情	facial expression	[ひょうじょう]
基地	base, military base	[きち]
駐車	parking	[ちゅうしゃ]
景気	economic conditions	[けいき]
比較的	comparatively, relatively	[ひかくてき]
植物	plant, vegetation	[しょくぶつ]
世間	world, the public	[せけん]
戦い	battle, fight	[たたかい]
限界	limit, limitation	[げんかい]
抜く	pull (something) out	[ぬく]
反映	reflection	[はんえい]
最低	lowest, worst	[さいてい]
狙う	aim, be after	[ねらう]
微妙	subtle, delicate	[びみょう]
結ぶ	tie, join	[むすぶ]
青年	young man	[せいねん]
劇場	theater	[げきじょう]
要するに	in a word, in short	[ようするに]
真剣	serious, attentive	[しんけん]
講義	lecture	[こうぎ]
貴重	precious, valuable	[きちょう]
工夫	scheme, devise, trick	[くふう]
幅	width, breadth	[はば]
必ずしも	not always, not necessarily	[かならずしも]
券	voucher, ticket	[けん]
意外	unexpected, surprising	[いがい]
重視	importance, value	[じゅうし]
医学	medical science, medicine	[いがく]
プラス	plus, advantage
刺激	stimulus	[しげき]
中間	middle, between	[ちゅうかん]
柔道	judo	[じゅうどう]
削る	scrape, cut back	[けずる]
上昇	rise, upturn	[じょうしょう]
攻撃	attack, assault	[こうげき]
候補	candidate	[こうほ]
主張	claim, assertion	[しゅちょう]
条件	condition, term	[じょうけん]
援助	aid, assistance	[えんじょ]
作者	writer, creator of an artwork	[さくしゃ]
賛成	approval, agreement	[さんせい]
法則	law, principle	[ほうそく]
科目	school subject	[かもく]
務める	perform a duty, play a role	[つとめる]
鉄道	railway	[てつどう]
従う	follow, obey	[したがう]
叫ぶ	shout, cry out	[さけぶ]
組む	pair up, partner with	[くむ]
印刷	printing	[いんさつ]
一致	agreement, match	[いっち]
筆者	writer, author	[ひっしゃ]
模様	pattern, design	[もよう]
速度	speed, velocity	[そくど]
外部	outside, outer	[がいぶ]
重ねる	put (something) on top of another, pile up	[かさねる]
抵抗	resistance	[ていこう]
定期	regular, periodic (thing)	[ていき]
混乱	chaos, confusion	[こんらん]
自殺	suicide	[じさつ]
幸い	fortunately, thankfully	[さいわい]
神様	god (polite)	[かみさま]
参る	go, come (humble)	[まいる]
城	castle	[しろ]
シーズン	season (loan word), time period when something is commonly done
筋	muscle, nerve	[すじ]
たとえ	even if, granting that
天皇	emperor	[てんのう]
ともかく	at any rate, in any case
題	title, topic	[だい]
運	fortune, luck	[うん]
不満	dissatisfaction, discontent	[ふまん]
原理	mechanism, theory	[げんり]
楽器	musical instrument	[がっき]
詩	poetry, poem	[し]
容易	easy, simple (formal)	[ようい]
滞在	stay	[たいざい]
各地	every place, various parts	[かくち]
済む	be settled, complete	[すむ]
香り	fragrance	[かおり]
老人	old person, elderly	[ろうじん]
一瞬	instant, moment	[いっしゅん]
当日	the day (of the event etc.)	[とうじつ]
割合	rate, proportion	[わりあい]
正式	formal, proper	[せいしき]
出場	participation (in a sports competition, etc.)	[しゅつじょう]
寄せる	draw (something) near	[よせる]
板	board, plank	[いた]
張る	strain, be stretched	[はる]
実績	results achieved, performance	[じっせき]
頼る	rely on, depend on	[たよる]
申し訳	excuse, apology	[もうしわけ]
ふと	suddenly, unintentionally
回転	spin, rotation	[かいてん]
ステージ	stage (for a performance)
広げる	spread (something)	[ひろげる]
通す	pass (someone/something) through	[とおす]
知事	governor	[ちじ]
勝負	victory or defeat, game	[しょうぶ]
やがて	soon, before long
直後	immediately after	[ちょくご]
奪う	rob, take by force	[うばう]
救う	save, relieve	[すくう]
測定	measure	[そくてい]
道具	tool	[どうぐ]
刑事	detective	[けいじ]
症状	symptom	[しょうじょう]
勢い	vigor, momentum	[いきおい]
表面	surface	[ひょうめん]
列	row, line	[れつ]
腹	belly (often used by men)	[はら]
玉	bead, ball	[たま]
学会	academic association, academic conference	[がっかい]
承認	approval, recognition	[しょうにん]
プラン	plan (loan word)
書店	bookstore (formal)	[しょてん]
祈る	pray, wish for	[いのる]
意志	will, volition	[いし]
暮らし	living, livelihood	[くらし]
勇気	courage	[ゆうき]
売買	buying and selling	[ばいばい]
生まれ	birth, origin	[うまれ]
確率	probability, chance	[かくりつ]
予防	prevention, protection	[よぼう]
爆発	explosion, eruption	[ばくはつ]
マッチ	match, matchbox
資金	funds, capital	[しきん]
投資	investment	[とうし]
規模	scale, scope	[きぼ]
業者	contractor (company)	[ぎょうしゃ]
首相	prime minister, premier	[しゅしょう]
語る	tell, talk	[かたる]
対象	target, object	[たいしょう]
調査	investigation, examination	[ちょうさ]
実施	implementation, enforcement	[じっし]
対立	opposition, confrontation	[たいりつ]
構成	composition, organization	[こうせい]
方針	policy, principle	[ほうしん]
対策	measure, countermeasure	[たいさく]
評価	evaluation, reputation	[ひょうか]
国会	National Diet, parliament	[こっかい]
抜ける	come out, leave	[ぬける]
見解	opinion, view	[けんかい]
程	extent, limit	[ほど]
取得	acquisition	[しゅとく]
信仰	faith, religious belief	[しんこう]
解放	release, setting free	[かいほう]
カバー	cover, covering (loan word)
発電	generation of electricity	[はつでん]
損害	damage, loss	[そんがい]
電力	electric power, electricity	[でんりょく]
矛盾	contradiction	[むじゅん]
性能	performance, capacity	[せいのう]
大いに	a lot, to the great extent	[おおいに]
影	shadow, shade	[かげ]
性質	nature, property	[せいしつ]
必死	desperate	[ひっし]
神経	nerves	[しんけい]
意義	meaning, significance	[いぎ]
延長	extension, prolongation	[えんちょう]
観客	audience, spectator	[かんきゃく]
武器	weapon, arms	[ぶき]
深刻	serious, grave	[しんこく]
方面	direction, area	[ほうめん]
直前	just before, immediately prior	[ちょくぜん]
部品	parts, accessories	[ぶひん]
慎重	discreet, prudent	[しんちょう]
学問	learning, scholarship	[がくもん]
伸ばす	stretch, grow (something)	[のばす]
劇	drama, play	[げき]
区別	distinction, discrimination	[くべつ]
しばしば	often, frequently (literary)
競技	sports game, competitive sport	[きょうぎ]
辺り	vicinity, around	[あたり]
素直	honest, straightforward	[すなお]
人事	human affairs, personnel affairs	[じんじ]
不正	fraud, injustice	[ふせい]
議長	chairperson	[ぎちょう]
応用	application, usage	[おうよう]
どんなに	how much, no matter how much or how many
政党	political party	[せいとう]
一生	lifetime	[いっしょう]
底	bottom, depth	[そこ]
免許	license, qualification	[めんきょ]
強力	powerful	[きょうりょく]
実力	(real) ability, capability	[じつりょく]
防ぐ	prevent	[ふせぐ]
順	order, in order of	[じゅん]
作曲	composition (music)	[さっきょく]
失業	unemployment, loss of job	[しつぎょう]
任せる	entrust to, leave it to	[まかせる]
指す	point to, aim at	[さす]
中古	secondhand (used) goods	[ちゅうこ]
高級	high-ranking, high-class	[こうきゅう]
存じる	think, know (humble)	[ぞんじる]
息	breath	[いき]
豊富	abundant, plentiful	[ほうふ]
余り	remainder, leftover	[あまり]
優秀	excellent, exceptional	[ゆうしゅう]
加わる	join in	[くわわる]
発音	pronunciation	[はつおん]
体系	system, organization	[たいけい]
同一	totally identical, same	[どういつ]
列車	train	[れっしゃ]
完了	completion (of a task, preparation, etc.), finish	[かんりょう]
地位	position, status	[ちい]
進歩	progress, advancement	[しんぽ]
欄	column, field	[らん]
好み	taste, preference	[このみ]
移転	relocation, move	[いてん]
全般	general, all-round	[ぜんぱん]
集合	gathering, aggregation	[しゅうごう]
増す	increase	[ます]
共に	together (formal)	[ともに]
効く	take effect, work	[きく]
文明	civilization, culture	[ぶんめい]
流行	fashion, trend (rather casual)	[はやり]
商店	shop, store (often used in store names)	[しょうてん]
輝く	shine, glitter	[かがやく]
当てる	guess, hit the jackpot	[あてる]
農家	farm	[のうか]
損	loss, damage	[そん]
男子	boy (usually over the age of 7), young man	[だんし]
育児	childcare, child-raising	[いくじ]
学部	faculty, department	[がくぶ]
苦しむ	suffer	[くるしむ]
行事	regular event	[ぎょうじ]
リズム	rhythm
例外	exception	[れいがい]
主婦	housewife	[しゅふ]
疑う	doubt, suspect	[うたがう]
取り入れる	take in, adopt	[とりいれる]
柱	pillar, column	[はしら]
旗	flag, banner	[はた]
木綿	cotton	[もめん]
導入	introduction, implementation	[どうにゅう]
政権	political power, regime	[せいけん]
改革	reform	[かいかく]
各国	each country	[かっこく]
占める	occupy, hold	[しめる]
実現	realization, actualization	[じつげん]
交渉	negotiation, bargaining	[こうしょう]
発生	occurrence, happening	[はっせい]
用いる	use, through use of, adopt	[もちいる]
カーブ	curve
商売	trade, business	[しょうばい]
恐らく	probably	[おそらく]
短気	short temper	[たんき]
付近	neighborhood, vicinity	[ふきん]
犯人	criminal, offender	[はんにん]
門	gate, entrance	[もん]
永遠	eternity	[えいえん]
人工	artificial	[じんこう]
広場	open space, plaza	[ひろば]
ダム	dam
観測	observation (with the use of equipment or devices)	[かんそく]
純粋	pure, unmixed	[じゅんすい]
覚悟	readiness, resolution	[かくご]
支出	expense, spending	[ししゅつ]
まさか	never (in a million years)
疲れ	fatigue, exhaustion	[つかれ]
借金	borrowing money, debt	[しゃっきん]
囲む	surround, encircle	[かこむ]
谷	valley	[たに]
辞典	(individual) dictionary	[じてん]
大戦	world war, great war	[たいせん]
才能	talent, ability	[さいのう]
発明	invention	[はつめい]
溢れる	overflow, flood	[あふれる]
幸福	(long-term) happiness, happy	[こうふく]
通知	notification	[つうち]
汚染	pollution, contamination	[おせん]
見直す	change one's view, review	[みなおす]
冷静	cool, calm	[れいせい]
血液	blood (formal)	[けつえき]
味わう	savor, appreciate	[あじわう]
オリンピック	the Olympics
独特	unique, distinct	[どくとく]
開放	open (to the public)	[かいほう]
面積	area, square measure	[めんせき]
熱心	enthusiasm, zeal	[ねっしん]
さす	pour, fill, add
段	step, grade, rank	[だん]
呼吸	breathing, respiration	[こきゅう]
日程	daily schedule	[にってい]
友	friend, companion (literary)	[とも]
好む	like, be fond of	[このむ]
積む	pile up, load	[つむ]
保健	preservation of health	[ほけん]
拡張	expansion, extension	[かくちょう]
ピン	hairpin, pin
目次	table of contents	[もくじ]
看板	signboard, billboard	[かんばん]
果たして	really	[はたして]
就任	inauguration, assumption (of office)	[しゅうにん]
有利	advantage, profitable	[ゆうり]
感心	admiration	[かんしん]
庁	public office, agency	[ちょう]
家具	furniture	[かぐ]
筋肉	muscle	[きんにく]
西洋	the West	[せいよう]
外す	remove (something), take off	[はずす]
同時	simultaneous, at the same time	[どうじ]
学科	school subject, academic department	[がっか]
衛生	hygiene, sanitation	[えいせい]
愛情	love, affection	[あいじょう]
余計	unnecessary, extra	[よけい]
格好	shape, appearance	[かっこう]
平等	equal, fair	[びょうどう]
欠ける	be chipped, be missing	[かける]
努める	endeavor, make efforts	[つとめる]
経由	via, through	[けいゆ]
勝ち	win, victory	[かち]
透明	transparent, clear	[とうめい]
映る	be reflected, appear	[うつる]
一層	(even) more	[いっそう]
期限	time limit, deadline	[きげん]
警告	warning, admonition	[けいこく]
新鮮	fresh	[しんせん]
鉄	iron	[てつ]
通訳	interpreting, interpreter	[つうやく]
吸収	absorption, merger	[きゅうしゅう]
以後	from now on, hereafter	[いご]
巡る	make a round	[めぐる]
嫌う	dislike, hate	[きらう]
収穫	harvest, harvesting	[しゅうかく]
俳優	actor	[はいゆう]
先頭	forefront, head	[せんとう]
皮	peel, skin	[かわ]
そろう	be (all) together, become complete
物事	things	[ものごと]
入場	entrance, admission	[にゅうじょう]
記入	entry, fill in	[きにゅう]
響く	reverberate, vibrate	[ひびく]
重なる	come one after another, overlap	[かさなる]
国境	national border	[こっきょう]
およそ	approximately, about
笑い	laughter, laugh	[わらい]
典型	model, typical	[てんけい]
恵まれる	be blessed, be fortunate enough	[めぐまれる]
後者	the latter	[こうしゃ]
沖	offshore	[おき]
結合	combination, joining	[けつごう]
政策	policy, political measure	[せいさく]
文書	document, writing	[ぶんしょ]
心臓	heart	[しんぞう]
恐れる	fear, worry	[おそれる]
女優	actress	[じょゆう]
返る	return, go back	[かえる]
実用	practical use, utility	[じつよう]
演劇	drama, theatrical performance	[えんげき]
人種	race, racial group	[じんしゅ]
有料	fee-charging, paid	[ゆうりょう]
住まい	dwelling, residence	[すまい]
急速	rapid, swift	[きゅうそく]
輸送	transport, ship	[ゆそう]
高等	advanced, high-grade	[こうとう]
天然	nature, not artificial	[てんねん]
知人	acquaintance (formal)	[ちじん]
まとまる	come together, agree on
睡眠	sleep	[すいみん]
解く	solve (a problem), unknot	[とく]
自慢	showing off, boast	[じまん]
国語	national language, Japanese	[こくご]
焦点	focus, focal point	[しょうてん]
食料	food (formal)	[しょくりょう]
黙る	become silent, shut one's mouth	[だまる]
貧しい	poor, impoverished	[まずしい]
増大	increase, enlargement	[ぞうだい]
組み合わせ	combination	[くみあわせ]
金属	metal	[きんぞく]
評判	reputation	[ひょうばん]
絞る	wring out, squeeze	[しぼる]
コーチ	coach
栄養	nutrition, nourishment	[えいよう]
半ば	middle, halfway	[なかば]
豆	bean, peas	[まめ]
仲	relationship	[なか]
鑑賞	viewing, enjoyment (of art)	[かんしょう]
覆う	cover up	[おおう]
臨時	temporary, provisional	[りんじ]
ジャーナリスト	journalist
せめて	at least
働き	work, workings	[はたらき]
論じる	argue, discuss	[ろんじる]
演説	speech, address	[えんぜつ]
取り出す	take out, pull out	[とりだす]
窓口	window, contact	[まどぐち]
もともと	originally, by nature (colloquial)
勧める	suggest, recommend	[すすめる]
飽きる	get tired of	[あきる]
飛ばす	fly (something)	[とばす]
根	root	[ね]
突っ込む	thrust in, run into	[つっこむ]
端	end, edge	[はし]
スライド	slide
乾燥	drying up, desiccation	[かんそう]
立ち上がる	stand up, take action	[たちあがる]
サークル	circle, club
憧れる	yearn after, long for	[あこがれる]
都会	urban city, urban area	[とかい]
花火	fireworks	[はなび]
回数	frequency, number of times	[かいすう]
墓	grave, tomb	[はか]
表紙	cover (of a book, etc.)	[ひょうし]
泉	spring, fountain	[いずみ]
冒険	adventure, venture	[ぼうけん]
大陸	continent	[たいりく]
角度	angle	[かくど]
破る	defeat	[やぶる]
語学	language study	[ごがく]
クラシック	classical music, the classics
記号	symbol, mark	[きごう]
幼児	young child	[ようじ]
稽古	practice, training (for traditional arts, martial arts, etc.)	[けいこ]
来日	visit to Japan	[らいにち]
縦	lengthwise, vertical	[たて]
順調	favorable condition, smooth progress	[じゅんちょう]
満ちる	become full, wax	[みちる]
飼う	keep (an animal)	[かう]
付き合い	social obligation	[つきあい]
軍隊	troops, military forces	[ぐんたい]
もしも	if, if ever
プリント	print (loan word)
手間	time and effort	[てま]
正面	front, face	[しょうめん]
地帯	zone, area	[ちたい]
塔	tower	[とう]
役所	public office	[やくしょ]
定価	regular price	[ていか]
休暇	holiday, vacation	[きゅうか]
行方	one's whereabouts	[ゆくえ]
批評	criticism, review	[ひひょう]
つぐ	pour, serve (drinks)
別れ	separation, parting	[わかれ]
図書	books	[としょ]
ボーナス	bonus
例える	compare, liken	[たとえる]
学年	school year, grade	[がくねん]
砂	sand	[すな]
ポスター	poster
衝突	collision, conflict	[しょうとつ]
詰まる	get clogged, become stuffed	[つまる]
崩れる	crumble, collapse	[くずれる]
全身	the whole body	[ぜんしん]
偉大	great, mighty	[いだい]
拝見	look at, see (humble)	[はいけん]
願い	wish	[ねがい]
解散	breakup, dissolution	[かいさん]
文法	grammar	[ぶんぽう]
重点	important point, emphasis	[じゅうてん]
悲劇	tragedy	[ひげき]
炎	flame, blaze	[ほのお]
縮小	reduction, cutdown	[しゅくしょう]
農村	farming village, agricultural community	[のうそん]
婦人	woman, lady (old and formal)	[ふじん]
竹	bamboo	[たけ]
平日	weekday	[へいじつ]
皮膚	skin	[ひふ]
外れる	come off	[はずれる]
金銭	money (formal)	[きんせん]
レンズ	lens
公平	fairness, equality	[こうへい]
照らす	illuminate, shine on	[てらす]
改造	reconstruction, reorganization	[かいぞう]
済ませる	get done with (something)	[すませる]
区域	zone, district	[くいき]
マイク	microphone
鋭い	sharp, acute	[するどい]
まとめ	summary, conclusion
平気	nonchalant, calm	[へいき]
予備	reserve, extra	[よび]
入社	joining a company	[にゅうしゃ]
出勤	going to work, attendance at work	[しゅっきん]
引き出す	draw out, bring out	[ひきだす]
棒	stick	[ぼう]
どうか	please (used in difficult situations)
節約	saving, thrift	[せつやく]
付属	attachment, belonging	[ふぞく]
合同	joint, combination	[ごうどう]
司会	master of ceremonies, host	[しかい]
湧く	well up	[わく]
吐く	holler, vomit	[はく]
無限	infinite, endless	[むげん]
間接	indirect	[かんせつ]
粉	powder, flour	[こな]
省略	omission, abbreviation	[しょうりゃく]
だます	deceive, cheat
郊外	suburbs	[こうがい]
代金	charge, fee (in exchange for goods, etc.)	[だいきん]
直ちに	at once, immediately	[ただちに]
境界	boundary, border	[きょうかい]
毒	poison, harm	[どく]
用途	purpose of use, usage	[ようと]
味方	ally, being on one's side	[みかた]
癖	habit	[くせ]
主役	leading role	[しゅやく]
布	cloth	[ぬの]
英文	English sentence	[えいぶん]
そろえる	make (something) uniform, put (something) in order
跡	trace, imprint	[あと]
幕	stage curtain, theater drape	[まく]
教養	culture, education	[きょうよう]
前進	advance, proceed	[ぜんしん]
温暖	warm, mild (weather)	[おんだん]
予報	forecast, prediction	[よほう]
係	person in charge	[かかり]
飛び出す	fly out, dash out	[とびだす]
煙	smoke	[けむり]
肯定	affirmation	[こうてい]
森林	forest, woodland	[しんりん]
試し	try-on, (by) way of experiment	[ためし]
地点	spot, point	[ちてん]
枝	branch, twig	[えだ]
寮	dormitory	[りょう]
幼い	little, childish	[おさない]
掘る	dig, unearth	[ほる]
岩	rock	[いわ]
支店	branch (office)	[してん]
出来上がる	be completed, be finished	[できあがる]
私立	private (institution)	[しりつ]
気候	climate	[きこう]
問い	question, inquiry	[とい]
詰める	stuff (something)	[つめる]
仮定	assumption, supposition	[かてい]
嵐	storm	[あらし]
寿命	life span	[じゅみょう]
撃つ	fire, shoot	[うつ]
一旦	once, one time	[いったん]
誤り	error, mistake	[あやまり]
故郷	hometown, birthplace (formal)	[こきょう]
急激	rapid, abrupt	[きゅうげき]
地面	surface, ground	[じめん]
大使	ambassador	[たいし]
感激	deep emotion, to be touched	[かんげき]
見出し	headline, heading	[みだし]
雇う	employ, hire	[やとう]
崩す	put (something) into disorder, destroy	[くずす]
つながり	connection, relationship
飛行	flight	[ひこう]
推薦	recommendation, nomination	[すいせん]
苦しみ	suffering, pain	[くるしみ]
診る	examine (doctor)	[みる]
計る	compute, measure (number or time)	[はかる]
命じる	order, give orders	[めいじる]
全力	all one's might, full capacity	[ぜんりょく]
世話	care, taking care of	[せわ]
タイヤ	tire
警官	police officer (formal)	[けいかん]
定員	capacity, fixed number (of people)	[ていいん]
消化	digestion	[しょうか]
倉庫	warehouse, storehouse	[そうこ]
始まり	beginning, start, cause	[はじまり]
穏やか	calm, quiet	[おだやか]
悲しみ	grief, sadness	[かなしみ]
前者	the former	[ぜんしゃ]
丘	hill	[おか]
接近	approach, to draw near	[せっきん]
飯	cooked rice, meal (vulgar language)	[めし]
はねる	run over, hit
先端	end, tip	[せんたん]
争う	compete, fight	[あらそう]
一流	top-ranked, world-class	[いちりゅう]
生き物	living creature	[いきもの]
実習	hands-on training, practical training	[じっしゅう]
譲る	give, hand over	[ゆずる]
後輩	one's junior	[こうはい]
漁業	fishery	[ぎょぎょう]
画家	artist, painter	[がか]
学期	school term, semester	[がっき]
裏切る	betray	[うらぎる]
幸運	good fortune, good luck	[こううん]
生存	existence, to be alive	[せいぞん]
地理	geography	[ちり]
海洋	ocean, sea	[かいよう]
家事	housework, domestic duties	[かじ]
解答	solution, answer	[かいとう]
死体	corpse	[したい]
採る	gather, pick	[とる]
外出	outing, going out	[がいしゅつ]
スピーカー	speaker
成人	adult, to be of age	[せいじん]
印	mark, symbol	[しるし]
儀式	ceremony, ritual	[ぎしき]
針	needle, (clock) hand	[はり]
挟む	pinch, get something caught (in)	[はさむ]
いくら	no matter how much
渋滞	traffic jam, backup	[じゅうたい]
地味	plain, modest	[じみ]
消防	fire fighting, fire prevention	[しょうぼう]
限度	limit, boundary	[げんど]
整う	be arranged, be ready	[ととのう]
欠点	fault, flaw	[けってん]
陰	shade	[かげ]
学力	academic ability	[がくりょく]
東洋	the East	[とうよう]
親戚	relative	[しんせき]
一家	household, family	[いっか]
体育	physical training, physical education	[たいいく]
賢い	wise, smart	[かしこい]
夫妻	husband and wife, Mr. and Mrs.	[ふさい]
原料	raw material	[げんりょう]
苦痛	pain, agony	[くつう]
浮く	rise to a surface, float	[うく]
テンポ	tempo, pace
上級	higher grade, advanced class	[じょうきゅう]
専攻	major	[せんこう]
誓う	vow, swear	[ちかう]
オーケストラ	orchestra
区分	division, segment	[くぶん]
アンテナ	antenna
スタンド	table lamp, desk lamp
重量	weight (often used for something heavy)	[じゅうりょう]
道徳	morality, ethic	[どうとく]
混ぜる	mix (something)	[まぜる]
中年	middle age	[ちゅうねん]
派手	flashy, loud	[はで]
案外	unexpectedly	[あんがい]
苦情	complaint on actual damage, loss, etc. (formal)	[くじょう]
系統	system, lineage	[けいとう]
嫁	bride, daughter-in-law, one's wife	[よめ]
ブレーキ	brake
力強い	powerful, vigorous	[ちからづよい]
役人	government official	[やくにん]
周り	vicinity, surroundings	[まわり]
属する	belong, be a member (of)	[ぞくする]
高価	high-priced, expensive	[こうか]
改める	reform, change for the better	[あらためる]
狂う	become insane, get out of order	[くるう]
乗客	passenger	[じょうきゃく]
座席	seat	[ざせき]
盛ん	prosperous, thriving	[さかん]
ナンバー	number (loan word)
粒	grain, drop	[つぶ]
夜間	night, nighttime	[やかん]
ストップ	stop
等しい	equal, same	[ひとしい]
散る	scatter, fall	[ちる]
服装	attire, way of dressing	[ふくそう]
中旬	middle ten days of a month	[ちゅうじゅん]
膨らむ	swell, inflate	[ふくらむ]
納める	pay (tax, fee etc.)	[おさめる]
産地	production center, producing area	[さんち]
生える	grow, spring up	[はえる]
夫人	wife, Mrs.	[ふじん]
診察	medical examination	[しんさつ]
縛る	bind, tie	[しばる]
刻む	cut, chop	[きざむ]
攻める	make an attack, assault	[せめる]
夢中	be absorbed, be engrossed	[むちゅう]
火災	fire, fire disaster	[かさい]
裸	naked body, bareness	[はだか]
トンネル	tunnel
公衆	general public, for public use	[こうしゅう]
行列	queue, line	[ぎょうれつ]
独り言	to talk to oneself	[ひとりごと]
皮肉	sarcasm, irony	[ひにく]
砂漠	desert	[さばく]
猿	monkey, ape	[さる]
梅	plum	[うめ]
詩人	poet	[しじん]
霧	fog, mist	[きり]
まく	sow (seeds)
王様	king (polite)	[おうさま]
ハンドル	steering wheel
小遣い	pocket money, allowance	[こづかい]
退屈	boring, tedious	[たいくつ]
クリーム	cream
下旬	the last ten days (of a month)	[げじゅん]
劣る	be inferior to, be worse than	[おとる]
娯楽	amusement, pastime	[ごらく]
たまらない	can't stand, unbearable, irresistible
ベテラン	experienced person, veteran
見上げる	look up	[みあげる]
盛る	heap up, fill	[もる]
コンクリート	concrete
不利	disadvantage	[ふり]
強引	coercive, persistent	[ごういん]
スピーチ	speech
刀	sword, blade	[かたな]
石炭	coal	[せきたん]
天候	weather	[てんこう]
登山	mountain climbing	[とざん]
中世	Middle Ages, medieval age	[ちゅうせい]
騒音	(loud) noise, din	[そうおん]
奥様	married woman, someone's wife	[おくさま]
岸	shore, bank	[きし]
ベンチ	bench
酸素	oxygen	[さんそ]
ビタミン	vitamin
鳴らす	make a sound with (something)	[ならす]
たまる	accumulate, store up
親友	best friend	[しんゆう]
丼	bowl	[どんぶり]
切れ	sharpness	[きれ]
潰す	crush (something)	[つぶす]
固まる	harden, solidify	[かたまる]
性別	gender	[せいべつ]
点数	point, score	[てんすう]
題名	title	[だいめい]
横断	crossing, traversing	[おうだん]
容器	container	[ようき]
酔う	get drunk, get motion sickness	[よう]
兼ねる	serve two functions, combine	[かねる]
思い込む	assume, believe	[おもいこむ]
混じる	be blended, get mixed (distinguishable)	[まじる]
騒ぎ	clamor, commotion	[さわぎ]
差す	open (an umbrella)	[さす]
就く	set about a task, assume (a position)	[つく]
南北	north and south	[なんぼく]
筆	writing brush	[ふで]
開会	opening, start (of a meeting etc.)	[かいかい]
餌	bait, feed	[えさ]
水平	horizontal, level	[すいへい]
測る	measure (length, depth, distance or dimensions)	[はかる]
東西	east and west	[とうざい]
ぶつける	hit, strike (forcefully)
調節	adjustment	[ちょうせつ]
官庁	government office	[かんちょう]
助手	assistant	[じょしゅ]
マラソン	marathon
延期	postponement, deferment	[えんき]
各自	each one, every individual	[かくじ]
教わる	be taught, learn	[おそわる]
商人	merchant, trader	[しょうにん]
勘定	check, count	[かんじょう]
接する	come in contact, adjoin	[せっする]
害	harm, damage	[がい]
食欲	appetite	[しょくよく]
不自由	inconvenience, discomfort	[ふじゆう]
順序	order, sequence	[じゅんじょ]
役目	duty, role	[やくめ]
知能	intelligence, mental capacity	[ちのう]
心身	mind and body	[しんしん]
一昨日	the day before yesterday (formal)	[いっさくじつ]
呼び出す	call, page	[よびだす]
混雑	congestion, to be crowded	[こんざつ]
越す	go across, pass	[こす]
上達	progress, proficiency	[じょうたつ]
補う	supplement, replenish	[おぎなう]
祝う	celebrate, congratulate	[いわう]
友情	friendship	[ゆうじょう]
分解	taking apart	[ぶんかい]
公害	(environmental) pollution	[こうがい]
課程	course, curriculum	[かてい]
通行	passage, traffic	[つうこう]
書物	book, written stuff	[しょもつ]
都心	heart of a city, urban area	[としん]
永久	permanence, eternity	[えいきゅう]
交際	association, dating	[こうさい]
パイプ	pipe
よそ	somewhere else, not one's own
集まり	gathering, meeting	[あつまり]
特色	characteristic, uniqueness	[とくしょく]
出入り	coming and going	[でいり]
器具	equipment, instrument	[きぐ]
痛む	feel pain, hurt	[いたむ]
頭痛	headache	[ずつう]
唇	lip	[くちびる]
通路	pathway, aisle	[つうろ]
食物	food (mainly in writing)	[しょくもつ]
体操	gymnastics, physical exercise	[たいそう]
社説	editorial	[しゃせつ]
芽	bud, sprout	[め]
火山	volcano	[かざん]
冷凍	freeze, frozen	[れいとう]
パイロット	pilot
一昨年	the year before last (formal)	[いっさくねん]
明ける	dawn, end	[あける]
救助	rescue, save	[きゅうじょ]
決心	determination, resolution	[けっしん]
空中	in the air, in the sky	[くうちゅう]
荒れる	be wild, get rough	[あれる]
隅	corner	[すみ]
無数	countless, innumerable	[むすう]
間隔	interval, space	[かんかく]
要旨	overview, summary	[ようし]
餅	rice cake	[もち]
相撲	Japanese-style wrestling	[すもう]
斜め	diagonal, slant	[ななめ]
傾く	decline, go down	[かたむく]
モダン	modern
名詞	noun	[めいし]
離す	set (something) apart, let go (of)	[はなす]
休業	suspension of a business operation	[きゅうぎょう]
立ち止まる	stop, halt	[たちどまる]
強盗	robbery, burglar	[ごうとう]
次ぐ	rank next, come next	[つぐ]
半島	peninsula	[はんとう]
地名	name of a place	[ちめい]
液体	liquid form	[えきたい]
動詞	verb	[どうし]
先祖	forefather, ancestor	[せんぞ]
頬	cheek (common reading)	[ほお]
満員	full to capacity	[まんいん]
広める	spread (information etc.), make (something) known	[ひろめる]
転がる	roll over	[ころがる]
子孫	descendant, offspring	[しそん]
曲線	curve, curved line	[きょくせん]
郵送	mailing	[ゆうそう]
満点	perfect score	[まんてん]
水面	surface of the water	[すいめん]
虹	rainbow	[にじ]
実例	example, instance	[じつれい]
宝石	gem, jewel	[ほうせき]
巣	nest, den	[す]
境	boundary, border	[さかい]
湿度	humidity	[しつど]
手入れ	care, repair	[ていれ]
弱点	weak point, weakness	[じゃくてん]
平行	parallel	[へいこう]
ユーモア	humor
活字	printed type	[かつじ]
空き	vacancy, free time	[あき]
捕まる	be caught, be arrested	[つかまる]
長所	strong point, strength	[ちょうしょ]
貨物	freight, cargo	[かもつ]
溶ける	dissolve, melt	[とける]
効力	effect, validity	[こうりょく]
乗車	boarding, getting on board	[じょうしゃ]
実物	real thing, actual object	[じつぶつ]
超過	excess	[ちょうか]
絶えず	constantly, unremittingly	[たえず]
外科	surgery	[げか]
陽気	cheerful, merry	[ようき]
互い	each other (plain)	[たがい]
湾	bay, gulf	[わん]
続々	in succession, one after another	[ぞくぞく]
直径	diameter	[ちょっけい]
直線	straight line	[ちょくせん]
泥	mud	[どろ]
シャッター	shutter
名物	specialty, famous product	[めいぶつ]
平野	plain land	[へいや]
清潔	cleanliness, neatness	[せいけつ]
貝	shellfish, shell	[かい]
食卓	dining table	[しょくたく]
方言	dialect	[ほうげん]
まれ	rareness
双子	twins	[ふたご]
脱線	derailment	[だっせん]
客席	seat, passenger seat	[きゃくせき]
摩擦	friction	[まさつ]
重み	weight, importance	[おもみ]
発達	development, growth	[はったつ]
深まる	deepen, become deeper	[ふかまる]
浮かべる	float (something), set (something) afloat	[うかべる]
群れ	flock, herd	[むれ]
家屋	house, building	[かおく]
塊	mass, clump	[かたまり]
笛	whistle	[ふえ]
スマート	sophisticated, skillful
高層	high altitude, high-rise	[こうそう]
コンクール	contest, competition (mainly in arts)
適度	moderate, proper	[てきど]
採点	marking, grading	[さいてん]
牧場	stock farm, ranch	[ぼくじょう]
惜しい	almost, close	[おしい]
めでたい	happy (occasions), festive
鐘	bell, gong	[かね]
捜す	look for, search for (someone or something missing)	[さがす]
着ける	pull up, park (a vehicle)	[つける]
一通り	briefly, once over	[ひととおり]
内科	internal medicine	[ないか]
油断	inattention, carelessness	[ゆだん]
乱暴	violence, roughness, disorderliness	[らんぼう]
ダイヤモンド	diamond
連れ	companion	[つれ]
紅葉	autumn leaves, crimson foliage	[こうよう]
校舎	school building	[こうしゃ]
見当	estimate, guess	[けんとう]
女房	wife (literary)	[にょうぼう]
驚かす	surprise	[おどろかす]
頬	cheek (traditional reading)	[ほほ]
昇る	rise, ascend	[のぼる]
モーター	motor, engine
飾り	ornament, decoration	[かざり]
余分	excess, extra	[よぶん]
断定	decision, conclusion	[だんてい]
現す	show, reveal	[あらわす]
爽やか	fresh, clear	[さわやか]
便り	letter, correspondence	[たより]
団地	housing estate, housing complex	[だんち]
作物	crop, farm produce	[さくもつ]
枯れる	wither, die	[かれる]
愉快	pleasant, amusing	[ゆかい]
上旬	the first ten days (of a month)	[じょうじゅん]
平凡	common, ordinary	[へいぼん]
礼	bow, thanks	[れい]
綿	cotton (fabric)	[めん]
湿る	get damp, get wet	[しめる]
先ほど	some time ago, a little while ago	[さきほど]
暗記	memorization	[あんき]
銅	copper	[どう]
名人	master, expert	[めいじん]
差し上げる	give (humble)	[さしあげる]
大工	carpenter	[だいく]
足跡	footprint, footmark	[あしあと]
水素	hydrogen	[すいそ]
婚約	engagement	[こんやく]
商社	trading firm	[しょうしゃ]
初級	beginner class, elementary level	[しょきゅう]
失望	disappointment, loss of hope	[しつぼう]
見舞い	personal visit to a sick person	[みまい]
頂上	summit, top	[ちょうじょう]
上品	elegant, refined	[じょうひん]
盗難	theft	[とうなん]
メーター	meter
リットル	liter
醜い	ugly, bad-looking	[みにくい]
毎度	every time	[まいど]
骨折	breaking a bone	[こっせつ]
掲示	notice, post	[けいじ]
薬品	medicine, drug	[やくひん]
頂戴	getting, receiving	[ちょうだい]
ボーイ	waiter, porter
潰れる	be squashed, be smashed	[つぶれる]
見本	sample, model	[みほん]
葬式	funeral	[そうしき]
列島	archipelago	[れっとう]
省く	omit	[はぶく]
垂直	vertical, perpendicular	[すいちょく]
暴れる	act violently, rage about	[あばれる]
峠	mountain pass, ridge	[とうげ]
ヨット	sailboat, yacht
厳重	strictness, severity	[げんじゅう]
税関	customs office	[ぜいかん]
日差し	rays of the sun, sunlight	[ひざし]
芝生	lawn, turf	[しばふ]
下車	getting off	[げしゃ]
停電	blackout, power failure	[ていでん]
名所	famous place	[めいしょ]
気圧	atmospheric pressure	[きあつ]
父母	father and mother, parents	[ふぼ]
恋人	boyfriend or girlfriend	[こいびと]
リボン	ribbon
図書室	library room	[としょしつ]
万歳	hurray	[ばんざい]
自習	self-study	[じしゅう]
引き算	subtraction (math)	[ひきざん]
足し算	addition (math)	[たしざん]
チョーク	chalk
ノック	knock
休養	rest, recreation	[きゅうよう]
綱	thick rope	[つな]
日光	sunshine, sunlight	[にっこう]
空想	fantasy, daydreams	[くうそう]
勘	intuition, hunch	[かん]
ものすごい	tremendous
映す	reflect (something), project (an image)	[うつす]
熱帯	tropics	[ねったい]
揉む	rub, massage	[もむ]
合図	signal, sign	[あいず]
夜明け	dawn, daybreak	[よあけ]
有能	competent, capable	[ゆうのう]
望み	desire, hope	[のぞみ]
アクセント	accent, stress
揚げる	fry	[あげる]
束	bundle, bunch	[たば]
夕日	setting sun	[ゆうひ]
暮れる	get dark	[くれる]
オルガン	organ (music)
貸し	loan	[かし]
縫う	sew, stitch	[ぬう]
儲ける	make a profit, make money	[もうける]
延びる	extend, be postponed	[のびる]
むける	come off, peel
明かり	light, lighting	[あかり]
近頃	recently, these days	[ちかごろ]
体温	body temperature	[たいおん]
枚数	number of flat things	[まいすう]
両側	both sides	[りょうがわ]
県庁	prefectural office	[けんちょう]
脂	grease, lard	[あぶら]
憎む	hate, detest	[にくむ]
眺め	view, prospect	[ながめ]
索引	index	[さくいん]
混ざる	be mixed, be stirred	[まざる]
一段と	more, further	[いちだんと]
衣服	clothes, outer clothing	[いふく]
ヘリコプター	helicopter
たちまち	in a moment, suddenly
担ぐ	shoulder, carry	[かつぐ]
万一	if by any chance, just in case	[まんいち]
大小	size	[だいしょう]
要点	main point, gist	[ようてん]
真っ先	first thing, first	[まっさき]
鈍い	dull, slow	[にぶい]
花嫁	bride	[はなよめ]
向かい	opposite side	[むかい]
苦しめる	torment (someone), trouble (someone)	[くるしめる]
大して	(not) very, (not that) much	[たいして]
亡くす	lose (in death)	[なくす]
時速	speed per hour	[じそく]
消毒	disinfection, sterilization	[しょうどく]
能率	efficiency of work, etc. done in a certain time period	[のうりつ]
湿気	humidity, dampness	[しっけ]
小麦	wheat	[こむぎ]
生ずる	arise, bring about	[しょうずる]
はめる	put (something) into a hole, frame etc.
快晴	clear and fine weather	[かいせい]
噴火	eruption	[ふんか]
強気	assertiveness, being strong-willed	[つよき]
見下ろす	look down	[みおろす]
鎖	chain	[くさり]
祖先	ancestor	[そせん]
潜る	dive, go under the water	[もぐる]
塀	fence, wall	[へい]
暮れ	dusk, the end (of a season or a year)	[くれ]
ほえる	bark, roar
風船	balloon	[ふうせん]
引き分け	draw, tie	[ひきわけ]
逆らう	go against, rebel	[さからう]
稲	rice plant	[いね]
金庫	strong box, safe	[きんこ]
慰める	console, comfort	[なぐさめる]
墨	black ink	[すみ]
釘	nail, spike	[くぎ]
見かけ	looks, appearance	[みかけ]
コンセント	outlet
香水	perfume	[こうすい]
知らせ	notice, news	[しらせ]
区切る	divide, partition	[くぎる]
帰す	send (someone) home	[かえす]
植木	garden plant	[うえき]
放る	fling, throw	[ほうる]
雑音	noise, interference	[ざつおん]
中途	halfway	[ちゅうと]
ロッカー	locker
姓	family name, surname	[せい]
技師	engineer, technician	[ぎし]
器用	skillful, being good with one's hands	[きよう]
賞品	things given as a prize	[しょうひん]
開催	holding (of an event), opening	[かいさい]
議員	legislator, assembly member	[ぎいん]
装置	equipment, device	[そうち]
通過	passing, passage	[つうか]
従来	up to now, conventional	[じゅうらい]
普及	spread, diffusion	[ふきゅう]
存在	existence	[そんざい]
昭和	the Showa era	[しょうわ]
騒がしい	noisy, loud	[さわがしい]
迎え	greeting, picking (someone) up	[むかえ]
勤め	work, duties	[つとめ]
地元	local area, one's hometown	[じもと]
南極	the South Pole	[なんきょく]
澄む	become clear	[すむ]
実る	bear fruit, be fulfilled	[みのる]
小鳥	small bird	[ことり]
閉会	closing	[へいかい]
電球	light bulb	[でんきゅう]
在学	being in school	[ざいがく]
恩	debt of gratitude, kindness	[おん]
こぐ	row
お参り	visiting a shrine or temple	[おまいり]
ひねる	twist, turn
初歩	beginning, basic	[しょほ]
略す	abbreviate, omit	[りゃくす]
矢印	arrow	[やじるし]
形容詞	adjective	[けいようし]
バケツ	bucket
下町	(old) downtown	[したまち]
短所	weak point	[たんしょ]
溶かす	melt (something)	[とかす]
休息	rest	[きゅうそく]
放す	release, free	[はなす]
催し	(special or one-time) event	[もよおし]
汽車	steam train	[きしゃ]
目印	landmark, sign (to spot)	[めじるし]
私鉄	private railway	[してつ]
勝敗	victory or defeat	[しょうはい]
縮める	reduce (time, size etc.), shorten	[ちぢめる]
田植え	rice planting	[たうえ]
引き返す	go back, retrace one's steps	[ひきかえす]
代名詞	pronoun	[だいめいし]
ひきょう	playing dirty, mean
不運	misfortune, bad luck	[ふうん]
用心	care, caution	[ようじん]
大通り	main street	[おおどおり]
問答	questions and answers, dialogue	[もんどう]
ことわざ	proverb, (common) saying
下品	vulgar, coarse	[げひん]
なでる	stroke, pat
ためる	collect and store (something)
くむ	collect, scoop up
思いがけない	unexpected	[おもいがけない]
月給	monthly salary	[げっきゅう]
行儀	manners, behavior	[ぎょうぎ]
増減	increase and decrease, rise and fall	[ぞうげん]
彫る	engrave, carve	[ほる]
縄	rope, cord	[なわ]
編む	knit	[あむ]
幼稚	childish	[ようち]
絹	silk	[きぬ]
恨む	hold a grudge, feel resentment	[うらむ]
頼もしい	reliable, dependable	[たのもしい]
ちぎる	tear, tear off
当番	being on duty, person in charge	[とうばん]
羽根	feather	[はね]
目覚まし	waking up	[めざまし]
砕く	crush (something) into small pieces	[くだく]
車輪	wheel	[しゃりん]
嗅ぐ	smell, sniff	[かぐ]
頼み	request, favor	[たのみ]
終点	last stop, terminal	[しゅうてん]
免税	tax exemption	[めんぜい]
電線	electric wire	[でんせん]
明け方	dawn, near daybreak	[あけがた]
日の出	sunrise	[ひので]
灯油	kerosene, lamp oil	[とうゆ]
電報	telegram	[でんぽう]
講堂	lecture hall, auditorium	[こうどう]
平ら	flat, level	[たいら]
言い出す	bring up, say	[いいだす]
答案	exam paper, answer sheet	[とうあん]
溺れる	drown	[おぼれる]
公務員	public officer, civil servant	[こうむいん]
委員	committee member, delegate	[いいん]
発つ	start, leave	[たつ]
積極的	active, positive	[せっきょくてき]
違いない	without doubt, for sure	[ちがいない]
いけない	wrong, must not
適する	suit, be suitable	[てきする]
背広	business suit, business jacket	[せびろ]
親類	relatives (formal)	[しんるい]
展覧会	exhibition	[てんらんかい]
消極的	negative, passive	[しょうきょくてき]
奨学金	scholarship	[しょうがくきん]
大部分	large part, good part	[だいぶぶん]
苦心	pains, efforts	[くしん]
険しい	steep, rough	[けわしい]
校庭	school field	[こうてい]
投書	letter to the editor	[とうしょ]
受け持つ	be in charge of, teach	[うけもつ]
煙突	chimney, smokestack	[えんとつ]
交じる	be mingled, be mixed	[まじる]
ささやく	whisper
毛皮	fur	[けがわ]
どっと	burst (out laughing etc.)
割り算	division (math)	[わりざん]
空手	karate	[からて]
可	permitted, OK	[か]
会談	conversation, talk	[かいだん]
礼儀	good manners, courtesy	[れいぎ]
見舞う	visit someone sick	[みまう]
方角	direction, points of the compass	[ほうがく]
締め切る	close, fix a deadline	[しめきる]
半径	radius	[はんけい]
座敷	Japanese-style room	[ざしき]
障子	paper sliding-door	[しょうじ]
赤道	equator	[せきどう]
召し上がる	eat (honorific)	[めしあがる]
物音	noise, sound	[ものおと]
遠足	excursion	[えんそく]
日課	daily routine	[にっか]
遊園地	amusement park	[ゆうえんち]
ペンキ	paint
和服	Japanese clothes	[わふく]
蛍光灯	fluorescent light	[けいこうとう]
正門	main gate, main entrance	[せいもん]
下水	sewerage, drainage	[げすい]
副詞	adverb	[ふくし]
待合室	waiting room	[まちあいしつ]
車庫	garage	[しゃこ]
受話器	telephone receiver	[じゅわき]
総理大臣	prime minister of Japan	[そうりだいじん]
生け花	flower arrangement	[いけばな]
炊事	cooking (for oneself or one's family)	[すいじ]
北極	North Pole	[ほっきょく]
長方形	rectangle	[ちょうほうけい]
出迎え	picking someone up, greeting	[でむかえ]
看病	looking after a sick person	[かんびょう]
刺さる	stick, get stuck	[ささる]
霜	frost	[しも]
書道	Japanese calligraphy	[しょどう]
直角	right angle	[ちょっかく]
申し訳ない	sorry, inexcusable	[もうしわけない]
呼びかける	call, urge	[よびかける]
毛糸	woolen yarn, wool	[けいと]
作製	manufacture (of products, machinery, drawings etc.)	[さくせい]
車掌	train conductor	[しゃしょう]
やかましい	noisy, critical, strict
決まり	(informal) rule, regulation	[きまり]
縮む	shrink, contract	[ちぢむ]
跳ねる	bounce, hop	[はねる]
払い込む	pay in	[はらいこむ]
人通り	pedestrian traffic	[ひとどおり]
不規則	irregular	[ふきそく]
不平	discontent, complaint	[ふへい]
地平線	horizon where the sky meets the land	[ちへいせん]
務め	duty, responsibilities	[つとめ]
濁る	become turbid, get cloudy	[にごる]
自然科学	natural science	[しぜんかがく]
末っ子	youngest child	[すえっこ]
送別	farewell, send-off	[そうべつ]
プラットホーム	platform
海水浴	sea bathing	[かいすいよく]
くず	waste, scrap
白髪	white hair, gray hair	[しらが]
日用品	groceries, daily necessities	[にちようひん]
裏口	back door	[うらぐち]
断水	water stoppage	[だんすい]
迷信	superstition	[めいしん]
あちらこちら	all over, everywhere
衣食住	clothing and food and housing	[いしょくじゅう]
今にも	at any moment	[いまにも]
透き通る	become transparent, become clear	[すきとおる]
正方形	regular square (formal)	[せいほうけい]
近づける	bring (something) close	[ちかづける]
引っ込む	draw back, pull in	[ひっこむ]
朗らか	cheerful, bright	[ほがらか]
目上	one's superiors, one's seniors	[めうえ]
落第	failing an exam	[らくだい]
薄める	dilute (something), water down	[うすめる]
砕ける	be crushed, break	[くだける]
催促	reminding, urging	[さいそく]
静まる	become quiet, calm down	[しずまる]
上等	first-class, premium	[じょうとう]
ひとりでに	automatically, by oneself
噴水	water fountain	[ふんすい]
包帯	bandage	[ほうたい]
物差し	ruler	[ものさし]
やっつける	beat up
拝む	bow in veneration, pray	[おがむ]
始終	from beginning to end, constantly	[しじゅう]
人文科学	humanities	[じんぶんかがく]
調味料	seasoning	[ちょうみりょう]
漬ける	pickle, marinade	[つける]
倣う	copy, follow an example	[ならう]
花瓶	flower vase	[かびん]
災難	calamity, misfortune	[さいなん]
若々しい	youthful, young-looking	[わかわかしい]
逆さ	reverse, inversion	[さかさ]
敬う	respect, honor	[うやまう]
逃がす	let (someone/something) to escape	[にがす]
日当たり	exposure to the sun	[ひあたり]
交ぜる	mix (things distinguishable)	[まぜる]
もしかすると	possibly, by any chance
回数券	book of (discounted) tickets	[かいすうけん]
口紅	lipstick	[くちべに]
謙遜	modesty, humbleness	[けんそん]
貸し出し	lending service, checking out	[かしだし]
電灯	electric light	[でんとう]
恨み	grudge, hatred	[うらみ]
とっさに	at once, promptly
量る	measure (weight or volume)	[はかる]
不潔	dirty, filthy	[ふけつ]
不通	interruption of service	[ふつう]
待ち合わせる	meet by appointment	[まちあわせる]
三日月	crescent moon	[みかづき]
偶数	even number	[ぐうすう]
利口	clever, smart	[りこう]
座布団	Japanese cushion	[ざぶとん]
失恋	broken heart	[しつれん]
水平線	horizon where the sky meets the ocean	[すいへいせん]
直通	direct link	[ちょくつう]
伝染	contagion, infection	[でんせん]
残らず	with nothing left behind, without exception	[のこらず]
払い戻す	pay back, reimburse	[はらいもどす]
引っ掛かる	be caught, be trapped	[ひっかかる]
夕立	evening shower	[ゆうだち]
今に	before long, someday	[いまに]
器械	instrument, equipment	[きかい]
転がす	roll (something) over	[ころがす]
下書き	draft	[したがき]
仲直り	reconciliation, making up	[なかなおり]
煮える	become boiled, become simmered	[にえる]
憎い	hateful, abominable	[にくい]
迷子	lost child, lost person	[まいご]
くたびれる	get tired, be worn out
社会科学	social science	[しゃかいかがく]
便箋	letter paper	[びんせん]
交ざる	mix, mingle with	[まざる]
湯気	steam, vapor	[ゆげ]
道順	route, directions	[みちじゅん]
括弧	parentheses, brackets	[かっこ]
紙くず	wastepaper	[かみくず]
至急	urgent	[しきゅう]
洗面	washing one's face, washing up	[せんめん]
手洗い	washing hands	[てあらい]
定休日	regular holiday	[ていきゅうび]
出来上がり	completion, result	[できあがり]
肌着	undergarment	[はだぎ]
一休み	short break	[ひとやすみ]
湯飲み	teacup	[ゆのみ]
現れ	manifestation, indication	[あらわれ]
入れ物	container, holder	[いれもの]
休講	cancellation of a lecture	[きゅうこう]
射す	shine on	[さす]
釣り合う	balance out, match	[つりあう]
所々	here and there, in places	[ところどころ]
ふるさと	hometown, birthplace (colloquial)
ふわふわ	soft and fluffy
回り道	detour	[まわりみち]
よる	be caused by, be due to
お目にかかる	meet (humble)	[おめにかかる]
被せる	cover (something)	[かぶせる]
交替	shift, taking turns	[こうたい]
五十音	Japanese syllabary	[ごじゅうおん]
祭日	national holiday	[さいじつ]
言づける	leave a message	[ことづける]
さびる	rust, get rusty
しわ	wrinkle
重役	director, executive	[じゅうやく]
たんす	chest of drawers, wardrobe
つまずく	stumble, trip on
包み	package, parcel	[つつみ]
匂う	smell (pleasant)	[におう]
引き止める	dissuade someone from leaving, hold back	[ひきとめる]
塞がる	be closed up, be blocked	[ふさがる]
振り仮名	reading aid in kana characters	[ふりがな]
へそ	belly button
解く	undo, unfasten (something)	[ほどく]
よこす	send, hand over
欲張り	greedy	[よくばり]
詫びる	sincerely apologize	[わびる]
ばからしい	stupid, absurd
やたらに	frequently, persistently
委員会	committee	[いいんかい]
デモ	demonstration
一般に	generally, in general	[いっぱんに]
一斉に	all together, all at once	[いっせいに]
典型的	typical	[てんけいてき]
住宅地	residential district	[じゅうたくち]
出版社	publishing company, publisher	[しゅっぱんしゃ]
ため息	sigh	[ためいき]
電卓	calculator	[でんたく]
めいめい	each, individually
原稿用紙	manuscript paper	[げんこうようし]
貴重品	valuables	[きちょうひん]
弱み	weakness, disadvantage	[よわみ]
硬さ	hardness	[かたさ]
ちぎれる	be torn off, come off
ぶら下げる	hang (something) down	[ぶらさげる]
新学期	new term, new semester	[しんがっき]
打ち合わせる	arrange, discuss	[うちあわせる]
奇数	odd number	[きすう]
お坊さん	monk, priest	[おぼうさん]
植物園	botanical garden	[しょくぶつえん]
ほこり	dust
割り引き	discount, lower estimate	[わりびき]
洗面器	wash bowl	[せんめんき]
根拠	grounds, basis	[こんきょ]
保つ	preserve, retain	[たもつ]
ガイド	guide
航空券	airline ticket	[こうくうけん]
栓抜き	bottle opener	[せんぬき]
とがる	be sharp
臭う	stink (unpleasant)	[におう]
のんき	carefree, happy-go-lucky
はしご	ladder
引っ掛ける	hook (something) on	[ひっかける]
麓	foot of the mountain	[ふもと]
ほうき	broom
微笑む	smile	[ほほえむ]
真似	imitation, mimicry	[まね]
儲かる	be profitable, pay its way	[もうかる]
レクリエーション	recreation
ろうそく	candle
生き生きと	lively, vigorously	[いきいきと]
速達便	special delivery mail, express mail	[そくたつびん]
必死に	desperately	[ひっしに]
上がる	eat, drink (honorific)	[あがる]
荒い	harsh, rough	[あらい]
注ぐ	pour into (liquid)	[そそぐ]
流行	fashion, trend	[りゅうこう]
額	forehead	[ひたい]
一種	sort of, almost	[いっしゅ]
抱く	hug, hold	[だく]
柄	pattern, print	[がら]
上	upper, superior	[じょう]
下	lower, bottom	[げ]
盆	tray	[ぼん]
逆さま	upside-down, reverse	[さかさま]
割合に	relatively, rather	[わりあいに]
次々に	one after another, in succession	[つぎつぎに]
罰する	punish, penalize	[ばっする]
清書	clean copy, final copy	[せいしょ]
交わる	mingle, socialize	[まじわる]
受け取り	receipt	[うけとり]
にわかに	rapidly, at once
年月	time, years	[としつき]
都	capital, city	[みやこ]
方々	all directions, everywhere	[ほうぼう]
陸	land, shore	[りく]
能	ability, capability	[のう]
固体	solid, solid matter	[こたい]
半面	half, one side	[はんめん]
家主	owner of a rented house	[やぬし]
著す	write (a book)	[あらわす]
乗り越し	riding past one's stop	[のりこし]
日の入り	sunset	[ひのいり]
単数	singular	[たんすう]
エチケット	etiquette (loan word)
大層	greatly, exceedingly	[たいそう]
腰掛け	stool, seat (literary)	[こしかけ]
客間	guest room	[きゃくま]
仮名遣い	kana orthography, use of kana	[かなづかい]
温帯	temperate zone	[おんたい]
小数	decimal	[しょうすう]
熱する	heat (something)	[ねっする]
腰掛ける	sit down (literary)	[こしかける]
盆地	basin	[ぼんち]
並木	row (line) of trees	[なみき]
材木	timber, wood	[ざいもく]
元日	New Year's Day	[がんじつ]
たく	make (a fire)
照る	shine, blaze	[てる]
気体	gaseous body, gas	[きたい]
和英	Japanese-English	[わえい]
支援	support, backing	[しえん]
思い	thoughts, feelings	[おもい]
日々	daily, every day	[ひび]
せい	cause, blame
距離	distance	[きょり]
仕組み	construction, mechanism	[しくみ]
お前	you (vulgar language)	[おまえ]
男女	men and women	[だんじょ]
役立つ	be of use, come in handy	[やくだつ]
ロック	rock (music)
市内	in the city	[しない]
我が家	one's home	[わがや]
浮かぶ	float (on a surface)	[うかぶ]
生み出す	generate, produce	[うみだす]
たった	only, merely
キリスト	Christ
あえて	dare, boldly
抑える	suppress, bring under control	[おさえる]
見つめる	stare, gaze	[みつめる]
ハード	hard
幅広い	wide, profound	[はばひろい]
つなぐ	connect (someone, something)
申し込み	application, signing up	[もうしこみ]
向き	direction, turn	[むき]
持ち込む	bring in, carry on	[もちこむ]
徹底的	thorough	[てっていてき]
前向き	facing forward, positive	[まえむき]
録画	videotaping, recording	[ろくが]
喫煙	smoking	[きつえん]
乗り越える	overcome, get over	[のりこえる]
値上げ	price hike, price increase	[ねあげ]
まし	better, preferable
なぜか	for no reason
欲	desire, greed	[よく]
守備	defense, fielding	[しゅび]
闘う	fight, battle	[たたかう]
引き受ける	take on, accept	[ひきうける]
情けない	pathetic, pitiful	[なさけない]
年収	annual income	[ねんしゅう]
のぞく	peep, look in
持ち主	owner	[もちぬし]
同級生	classmate	[どうきゅうせい]
国道	national highway	[こくどう]
当たり	success, to come true	[あたり]
おかげ	with the help of, thanks to
プライド	pride
盛り上げる	bring excitement	[もりあげる]
つまむ	snack on
めくる	turn over
一口	mouthful, bite	[ひとくち]
当分	for some time, for the time being	[とうぶん]
日数	number of days	[にっすう]
値上がり	price rise, price increase	[ねあがり]
グラウンド	ground, (playing or sports) field
無関心	indifferent, not interested	[むかんしん]
思いやり	thoughtfulness, kindness	[おもいやり]
眠り	sleep, doze	[ねむり]
注意深い	careful	[ちゅういぶかい]
寝室	bedroom	[しんしつ]
ファックス	fax
人前	in front of people	[ひとまえ]
真夏	midsummer	[まなつ]
日ごろ	daily, usually	[ひごろ]
真夜中	midnight, middle of the night	[まよなか]
長生き	long life, longevity	[ながいき]
大雪	heavy snow	[おおゆき]
花束	flower bouquet	[はなたば]
ぱっと	suddenly, quickly
追伸	P.S.	[ついしん]
パンダ	panda
行き来	comings and goings	[いきき]
不器用	clumsy, unskillful	[ぶきよう]
三角形	triangle	[さんかっけい]
不機嫌	in a bad mood	[ふきげん]
笑い声	laughter	[わらいごえ]
立ち直る	get over, recover	[たちなおる]
足音	footstep (sound)	[あしおと]
第一	number one, first	[だいいち]
離陸	takeoff	[りりく]
追い抜く	pass, overtake	[おいぬく]
にこやか	smiling, beaming (face)
片側	one side	[かたがわ]
横顔	profile, side face	[よこがお]
取り消し	cancellation, revocation	[とりけし]
後ろ向き	facing backward	[うしろむき]
山登り	(light or easy) mountain climbing	[やまのぼり]
三流	third-rate	[さんりゅう]
爪切り	nail clipper, clipping nails	[つめきり]
せっかち	impatient, hasty
値下がり	fall in price	[ねさがり]
安売り	sale, bargain	[やすうり]
乗り越す	miss one's station	[のりこす]
寄り道	stopping by, going out of the way	[よりみち]
値切る	ask for a discount, haggle for bargains	[ねぎる]
長持ち	endurance, lasting long	[ながもち]
不注意	careless	[ふちゅうい]
いじめ	bullying
食費	food expenses	[しょくひ]
歩行者	pedestrian	[ほこうしゃ]
物覚え	memory, learning things	[ものおぼえ]
飲料水	drinking water (formal)	[いんりょうすい]
外れ	blank, losing	[はずれ]
ばら色	rose color, rosy	[ばらいろ]
精算	settlement of accounts, adjustment	[せいさん]
心細い	uneasy, lonely	[こころぼそい]
裏返し	inside out	[うらがえし]
夜更かし	staying up late at night	[よふかし]
いやらしい	lewd, nasty
勤め先	workplace	[つとめさき]
無口	reticent, quiet	[むくち]
勝手	selfish, self-centered	[かって]
何と	what, how, surprisingly	[なんと]
連休	consecutive holidays	[れんきゅう]
手軽	simple and convenient, easy-to-do	[てがる]
いやいや	reluctantly, grudgingly
つくづく	truly, deeply
賭ける	bet, stake	[かける]
引きずる	drag along, dwell on	[ひきずる]
異性	opposite sex	[いせい]
差し出す	stretch out, hold out	[さしだす]
脅かす	threaten, scare	[おどかす]
逃げ出す	run away, escape	[にげだす]
見習う	learn, follow someone's example	[みならう]
ごまかす	deceive, gloss over
日焼け	suntan	[ひやけ]
相応しい	suitable, appropriate	[ふさわしい]
飲み込む	swallow, gulp down	[のみこむ]
見落とす	miss, fail to notice	[みおとす]
前もって	in advance	[まえもって]
打ち明ける	confess, tell something on one's mind	[うちあける]
騒々しい	noisy, rowdy	[そうぞうしい]
設立	establishment (of a facility, public organization, etc.)	[せつりつ]
協議	discussion, deliberation	[きょうぎ]
達成	attainment, achievement	[たっせい]
運営	operation, management (of an organization, business, etc.)	[うんえい]
心	heart, mind	[こころ]
市	city (municipality)	[し]
事業	business, enterprise	[じぎょう]
固定	fixing, stability	[こてい]
対応	correspondence, response	[たいおう]
指摘	pointing out, indication	[してき]
保険	insurance	[ほけん]
行政	administration	[ぎょうせい]
行為	act, conduct	[こうい]
自己	oneself, own self	[じこ]
主	main, chief	[おも]
保護	protection, safeguard	[ほご]
認識	recognition, acknowledgment	[にんしき]
区	ward, district	[く]
土	soil, ground	[つち]
報道	news, report	[ほうどう]
むしろ	rather
光	light, ray	[ひかり]
種	seed	[たね]
値	numerical value	[あたい]
規定	provision, regulation	[きてい]
理論	theory	[りろん]
対	pair	[つい]
措置	measure, step	[そち]
推進	promotion	[すいしん]
確保	securement	[かくほ]
世	world, public	[よ]
規制	regulation, control	[きせい]
空間	space	[くうかん]
審議	deliberation, consideration	[しんぎ]
設置	installation, set up	[せっち]
雇用	employment, hiring	[こよう]
反応	reaction, response	[はんのう]
脳	brain	[のう]
運用	operation, management (of funds, assets, etc.)	[うんよう]
株式	stock	[かぶしき]
向上	improvement, progress	[こうじょう]
取材	collection of data, reporting	[しゅざい]
保障	guarantee, security	[ほしょう]
問う	ask, question	[とう]
原則	principle, general rule	[げんそく]
部門	division, category	[ぶもん]
出演	appearance (on stage, TV etc.)	[しゅつえん]
民族	race, ethnic group	[みんぞく]
革命	revolution	[かくめい]
図る	strive for, work to	[はかる]
実	fruit (of a plant), nut	[み]
いかに	how, in what way
避ける	avoid, evade	[さける]
福祉	welfare	[ふくし]
定める	determine, establish	[さだめる]
器	dish	[うつわ]
概念	general idea, concept	[がいねん]
果たす	accomplish, fulfill (purpose, responsibility, etc.)	[はたす]
判決	judicial decision, judgment	[はんけつ]
もたらす	bring about, lead to
再生	playback	[さいせい]
破壊	breaking, destruction	[はかい]
受け入れる	accept, accommodate	[うけいれる]
派遣	dispatch, sending	[はけん]
定義	definition	[ていぎ]
形成	formation	[けいせい]
記述	description	[きじゅつ]
軍事	military affairs	[ぐんじ]
不明	unknown, unclear, unidentified	[ふめい]
内閣	cabinet	[ないかく]
挑戦	challenge	[ちょうせん]
国連	United Nations	[こくれん]
実態	(actual) state, reality	[じったい]
獲得	acquisition, earning	[かくとく]
論理	logic	[ろんり]
極めて	extremely, very	[きわめて]
本質	essence, real nature	[ほんしつ]
及ぶ	reach, come up to	[およぶ]
強制	force	[きょうせい]
核	core, nucleus, nuclear	[かく]
同士	of the same kind, each other	[どうし]
条約	treaty	[じょうやく]
捜査	criminal investigation, search	[そうさ]
要因	factor, cause	[よういん]
合意	mutual agreement	[ごうい]
領域	territory, range	[りょういき]
一切	(not) at all (used to express intention)	[いっさい]
権力	power, authority	[けんりょく]
品質	quality of goods	[ひんしつ]
勤務	duty, work	[きんむ]
意図	intention, meaning	[いと]
復活	revival, being back on track	[ふっかつ]
進行	advancement, progress	[しんこう]
ミス	mistake (loan word)
専用	exclusive use	[せんよう]
経過	progression, lapse	[けいか]
災害	disaster	[さいがい]
統合	integration, merging	[とうごう]
値下げ	price reduction	[ねさげ]
素早い	quick	[すばやい]
長続き	lasting for a long time	[ながつづき]
ずる賢い	sly, cunning	[ずるがしこい]
あらかじめ	in advance (formal)
天	sky, Heaven	[てん]
知的	intelligent	[ちてき]
真実	true fact	[しんじつ]
相場	market price	[そうば]
拒否	rejection	[きょひ]
防衛	defense, protection	[ぼうえい]
どうやら	looks like, apparently
収集	collection, gathering	[しゅうしゅう]
各種	each kind, various	[かくしゅ]
根本	basis, root	[こんぽん]
主体	agent, main constituent	[しゅたい]
経る	go through, undergo	[へる]
流通	circulation, distribution	[りゅうつう]
要請	request, demand	[ようせい]
廃止	abolishment	[はいし]
確定	(final) decision	[かくてい]
振り返る	turn one's head, look back on	[ふりかえる]
退職	retirement, quitting a job	[たいしょく]
殺人	murder, homicide	[さつじん]
もはや	already, no longer
生かす	apply, make use of	[いかす]
決勝	final game, championship	[けっしょう]
所属	belonging, affiliation	[しょぞく]
演じる	perform, play	[えんじる]
帯	belt, sash	[おび]
応募	application (for a job, etc.)	[おうぼ]
枠	frame, limit	[わく]
情勢	state of things, situation	[じょうせい]
総会	general meeting	[そうかい]
指揮	command, initiative	[しき]
高まる	increase, intensify	[たかまる]
確信	firm belief, convincement	[かくしん]
公演	public performance	[こうえん]
正当	legitimate, valid	[せいとう]
自主	independence, autonomy	[じしゅ]
カット	cut (loan word)
満たす	fill (something), fulfill (a requirement, etc.)	[みたす]
悪	evil, badness	[あく]
運命	fate, destiny	[うんめい]
個々	each, individual	[ここ]
経費	expense	[けいひ]
象徴	symbol, icon	[しょうちょう]
圧力	pressure	[あつりょく]
作用	effect, acting on	[さよう]
盛り上がる	become lively, get excited	[もりあがる]
幹部	leader, executive	[かんぶ]
見通し	prospect	[みとおし]
導く	guide, lead	[みちびく]
進出	advancement, foray	[しんしゅつ]
格差	gap, disparity	[かくさ]
耐える	withstand, endure	[たえる]
大衆	general public, mass	[たいしゅう]
勢力	influence, power	[せいりょく]
報酬	compensation, reward	[ほうしゅう]
動向	trend	[どうこう]
怒り	anger, fury	[いかり]
仮に	supposing that, even if	[かりに]
ダウン	down, malfunction
身近	near oneself, close to one	[みぢか]
同意	consent, agreement	[どうい]
構想	concept, plot	[こうそう]
燃料	fuel	[ねんりょう]
側面	side	[そくめん]
非難	criticism, blame	[ひなん]
不良	bad, defective	[ふりょう]
美術	art, fine arts	[びじゅつ]
伝説	legend	[でんせつ]
決意	resolution, determination	[けつい]
沿う	follow along	[そう]
軸	axis	[じく]
成り立つ	consist of, depend on	[なりたつ]
兵器	arms, weapon	[へいき]
古代	ancient times	[こだい]
抗議	protest	[こうぎ]
生涯	life, lifetime	[しょうがい]
比率	ratio, proportion	[ひりつ]
ジャズ	jazz
誤る	make a wrong decision, do something wrong	[あやまる]
保守	conservation, keeping up	[ほしゅ]
欠く	lack	[かく]
対話	dialogue, conversation	[たいわ]
極端	extreme	[きょくたん]
正義	justice, rightness	[せいぎ]
襲う	raid, attack	[おそう]
人格	personality, one's human qualities	[じんかく]
意欲	morale, motivation	[いよく]
分離	separation, split	[ぶんり]
改良	improvement of machinery, land, product models, etc.	[かいりょう]
気軽	casual, easy	[きがる]
有する	possess, have (qualification etc.)	[ゆうする]
悪化	worsening, aggravation	[あっか]
名称	name (of an organization, thing, etc.), title	[めいしょう]
無線	wireless, radio	[むせん]
網	net	[あみ]
出産	childbirth, delivery	[しゅっさん]
業績	(academic or business) achievement, performance	[ぎょうせき]
まして	much more
憎らしい	hateful, obnoxious	[にくらしい]
おしまい	end
塞ぐ	block (something) up, cover in	[ふさぐ]
死	death	[し]
一見	at a glance	[いっけん]
興奮	excitement	[こうふん]
衛星	satellite	[えいせい]
込める	put (feeling, emotion etc.) into	[こめる]
肉体	body, flesh and blood	[にくたい]
埋める	fill (a place) with things or people, cover totally	[うずめる]
扉	hinged door	[とびら]
兵士	soldier	[へいし]
工学	engineering	[こうがく]
手元	at hand	[てもと]
権威	authority, power	[けんい]
独占	monopoly	[どくせん]
推測	conjecture, guess	[すいそく]
望ましい	desirable, recommended	[のぞましい]
試みる	try, attempt	[こころみる]
当選	winning an election, winning a prize	[とうせん]
預金	deposit, savings (with a bank)	[よきん]
いかにも	indeed, as if
健全	healthy, sound	[けんぜん]
弁護	defense	[べんご]
控える	hold back, cut back	[ひかえる]
天才	genius	[てんさい]
深める	deepen (understanding, knowledge, etc.)	[ふかめる]
犯す	commit (a crime), make (a mistake)	[おかす]
届け	notice, delivery	[とどけ]
衆議院	House of Representatives, Lower House	[しゅうぎいん]
促す	encourage, urge	[うながす]
本文	body text, this text	[ほんぶん]
反発	rebelling, backlash	[はんぱつ]
収支	earning and expense	[しゅうし]
活発	lively, active	[かっぱつ]
余地	room, space	[よち]
リード	the lead, taking a lead
国土	national land, national territory	[こくど]
受け止める	catch, receive	[うけとめる]
訂正	correction, amendment	[ていせい]
中継	(live) broadcasting	[ちゅうけい]
看護	nursing care	[かんご]
栽培	cultivation	[さいばい]
必然	necessity, inevitability	[ひつぜん]
恐れ	fear, (negative) possibility	[おそれ]
妊娠	pregnancy	[にんしん]
新人	newcomer	[しんじん]
正解	right/correct answer	[せいかい]
何だか	somehow, for some reason	[なんだか]
取り戻す	take back, recover	[とりもどす]
著しい	remarkable, striking	[いちじるしい]
到達	arrival, attainment	[とうたつ]
討論	debate, discussion	[とうろん]
人民	(common) people	[じんみん]
強烈	intense, strong	[きょうれつ]
仮	temporary state	[かり]
徒歩	on foot	[とほ]
何より	above all, most of all	[なにより]
著書	one's book, publication	[ちょしょ]
秩序	order, regularity	[ちつじょ]
争い	conflict, battle	[あらそい]
脂肪	fat	[しぼう]
天国	Heaven	[てんごく]
構う	care, bother	[かまう]
整える	adjust (something), tidy up	[ととのえる]
振動	vibration, oscillation	[しんどう]
回路	circuit	[かいろ]
孤独	solitary, lonely	[こどく]
最中	in the middle of, during	[さいちゅう]
要する	require, need	[ようする]
欲望	desire, craving	[よくぼう]
つぶやく	mutter, murmur
事柄	matter, affair	[ことがら]
分散	dispersion	[ぶんさん]
履歴	history, personal history	[りれき]
爆弾	bomb	[ばくだん]
理屈	reason, logic	[りくつ]
警戒	vigilance, caution	[けいかい]
オーバー	exaggerated, overly done (loan word)
組み合わせる	join together, combine	[くみあわせる]
部下	subordinate	[ぶか]
無効	invalid, expired	[むこう]
他方	other (side etc.)	[たほう]
真理	truth	[しんり]
引き揚げる	withdraw, salvage	[ひきあげる]
用紙	form, printed form	[ようし]
国産	domestically produced (goods)	[こくさん]
任務	duty, mission	[にんむ]
肝心	particularly essential, crucial	[かんじん]
遅れ	delay, being late	[おくれ]
照明	lighting	[しょうめい]
調和	harmony, agreement	[ちょうわ]
見込み	prospect, potential	[みこみ]
参議院	House of Councilors, Upper House	[さんぎいん]
適応	adaptation, adjustment	[てきおう]
避難	refuge, evacuation	[ひなん]
臨む	be present at	[のぞむ]
結成	organization, formation	[けっせい]
意向	intention	[いこう]
不況	depression, recession	[ふきょう]
公立	public, government-run	[こうりつ]
月日	time, days	[つきひ]
つながる	be connected, be linked
確立	strong establishment	[かくりつ]
有力	powerful, influential	[ゆうりょく]
祈り	prayer	[いのり]
秘書	secretary	[ひしょ]
合成	composition, synthesis	[ごうせい]
組み込む	incorporate, introduce (something) into	[くみこむ]
分担	share, allotment	[ぶんたん]
教え	teachings to follow	[おしえ]
固める	make (something) firm	[かためる]
禁じる	prohibit, ban	[きんじる]
定年	(mandatory) retirement age	[ていねん]
信念	belief, conviction	[しんねん]
乗り込む	go aboard, get on (a train etc.)	[のりこむ]
班	group, squad	[はん]
交わす	exchange (words etc.)	[かわす]
倒産	bankruptcy, going out of business	[とうさん]
取り扱い	handling, dealing with	[とりあつかい]
振り	swing, shake	[ふり]
疲労	fatigue	[ひろう]
傾ける	tilt, tip	[かたむける]
反射	reflection (of light)	[はんしゃ]
よほど	by far, quite a lot
中立	neutrality	[ちゅうりつ]
特有	particularity, uniqueness	[とくゆう]
費やす	spend	[ついやす]
きっちり	exactly, precisely
説く	explain, preach	[とく]
擦る	rub, scrub	[こする]
首脳	head of a state or an organization	[しゅのう]
騒動	commotion, riot	[そうどう]
妨害	hindrance, obstruction	[ぼうがい]
おまけ	free gift, discount
野党	opposition party	[やとう]
理性	reason, rationality	[りせい]
短縮	reduction, contraction	[たんしゅく]
仕上げる	finish (something) up	[しあげる]
主任	person in charge, chief	[しゅにん]
偏見	prejudice, bias	[へんけん]
言論	speech, discussion	[げんろん]
主題	main theme	[しゅだい]
対談	interview, talk	[たいだん]
中断	interruption, to temporarily stop (doing something)	[ちゅうだん]
起源	origin	[きげん]
気象	weather condition	[きしょう]
真相	the truth	[しんそう]
ゆとり	room, leeway
恥	shame, disgrace	[はじ]
英雄	hero	[えいゆう]
誠実	sincere, honest	[せいじつ]
良心	conscience	[りょうしん]
割り	rate	[わり]
明白	obvious, evident	[めいはく]
大胆	bold, fearless	[だいたん]
罰	punishment, penalty	[ばつ]
新築	newly built	[しんちく]
付け加える	add (as needed)	[つけくわえる]
反する	oppose, go against	[はんする]
領土	territory, domain	[りょうど]
家計	family budget	[かけい]
歯科	dentistry	[しか]
黒字	the black, surplus	[くろじ]
雑談	chat, idle talk	[ざつだん]
構える	set up, open (store etc.)	[かまえる]
乏しい	lacking, short of	[とぼしい]
敏感	sensitive, responsive	[びんかん]
主観	subjectivity	[しゅかん]
今更	after such a long time	[いまさら]
本能	instinct	[ほんのう]
遂げる	accomplish, achieve (something challenging)	[とげる]
負傷	hurt, injury	[ふしょう]
予言	prediction, forecast	[よげん]
議題	topic for discussion, agenda	[ぎだい]
連日	day after day, everyday	[れんじつ]
敗戦	lost battle, defeat	[はいせん]
訴え	appeal, accusation	[うったえ]
無意味	meaningless	[むいみ]
不在	to be out	[ふざい]
制服	uniform	[せいふく]
比例	(in) proportion	[ひれい]
同等	equality, equivalence	[どうとう]
登校	going to school, attending school	[とうこう]
追跡	chase, tracking down	[ついせき]
値する	be worth, deserve	[あたいする]
繁栄	prosperity, thriving	[はんえい]
強まる	become strong, gain strength	[つよまる]
養う	raise (children), foster	[やしなう]
経歴	personal background, experience	[けいれき]
無知	ignorant	[むち]
同居	living together	[どうきょ]
鮮やか	vivid	[あざやか]
物資	goods, supplies	[ぶっし]
テープ	tape
八百屋	greengrocery, vegetable shop	[やおや]
高等学校	high school	[こうとうがっこう]
番地	land number	[ばんち]
利息	interest (to be received)	[りそく]
悲鳴	shriek, scream (caused by surprise, pain, etc.)	[ひめい]
労力	labor or effort required for production	[ろうりょく]
追い出す	throw out, kick out	[おいだす]
衣類	clothes (category)	[いるい]
弱まる	weaken, abate	[よわまる]
好意	good feeling, affection	[こうい]
生理	period, menstruation	[せいり]
漏れる	leak, be disclosed	[もれる]
未知	unknown, strange	[みち]
打ち込む	devote oneself, dedicate oneself to	[うちこむ]
惜しむ	regret, feel sorry about	[おしむ]
富む	be full of, abound in	[とむ]
嘆く	grieve, mourn	[なげく]
外貨	foreign currency	[がいか]
突く	thrust, poke	[つく]
親しむ	get close to, get familiar with	[したしむ]
物体	object, physical body	[ぶったい]
一同	everybody, all (formal)	[いちどう]
創立	foundation (of a school, company, etc.)	[そうりつ]
利子	interest (to be paid)	[りし]
外観	external appearance, exterior	[がいかん]
誠に	truly, very	[まことに]
有益	beneficial, fruitful	[ゆうえき]
解ける	be solved, be resolved	[とける]
国交	diplomatic relations	[こっこう]
両立	managing two things, juggle	[りょうりつ]
高原	plateau, highland	[こうげん]
駆ける	run quickly	[かける]
近郊	area near a city	[きんこう]
到底	(not) possibly, utterly	[とうてい]
仕上げ	finishing touch	[しあげ]
進路	route, path	[しんろ]
結晶	crystal	[けっしょう]
文化財	cultural heritage	[ぶんかざい]
対比	contrast, comparison	[たいひ]
勤労	labor, serve	[きんろう]
対等	equal	[たいとう]
紳士	gentleman	[しんし]
暦	calendar, almanac	[こよみ]
救い	relief, salvation	[すくい]
溝	ditch, groove	[みぞ]
態勢	readiness, preparedness	[たいせい]
待遇	treatment (in the workplace etc.)	[たいぐう]
沿岸	coast, shore	[えんがん]
人柄	character, personality (usually positive)	[ひとがら]
期日	due date	[きじつ]
密か	secret, private	[ひそか]
見渡す	look out over	[みわたす]
引き取る	take back, take custody	[ひきとる]
継ぐ	succeed to, take over	[つぐ]
案の定	as expected, sure enough	[あんのじょう]
腸	intestines, entrails	[ちょう]
肺	lung	[はい]
血管	blood vessel	[けっかん]
洪水	flood, a shower of (something)	[こうずい]
入浴	taking a bath	[にゅうよく]
甘える	depend on someone's kindness, demand attention	[あまえる]
覚え	memory, learning	[おぼえ]
内心	on the inside, one's real intention	[ないしん]
地形	geographical features, landscape	[ちけい]
市街	urban area, downtown	[しがい]
追放	banishment, deportation	[ついほう]
華やか	gorgeous, colorful	[はなやか]
墓地	graveyard, cemetery	[ぼち]
無用	useless, no need	[むよう]
催す	feel, experience	[もよおす]
大家	landlord	[おおや]
日の丸	Japanese flag	[ひのまる]
採算	profitability	[さいさん]
着陸	landing	[ちゃくりく]
名付ける	name, give a name to	[なづける]
無言	silence, being speechless	[むごん]
染める	dye (something)	[そめる]
未定	state of being undecided	[みてい]
出世	social success in life, promotion	[しゅっせ]
送金	money transfer, sending money	[そうきん]
申し出る	offer, propose	[もうしでる]
過ち	fault, mistake	[あやまち]
行進	march, parade	[こうしん]
定食	set meal	[ていしょく]
目下	now, at present	[もっか]
操縦	steering, operating (a vehicle etc.)	[そうじゅう]
快い	comfortable, willing	[こころよい]
運送	shipping, transportation	[うんそう]
緩やか	loose, gentle	[ゆるやか]
多忙	busy	[たぼう]
内臓	internal organs	[ないぞう]
メロディー	melody
受かる	pass (an exam)	[うかる]
済ます	finish (something), make do	[すます]
出血	bleeding	[しゅっけつ]
着席	taking a seat	[ちゃくせき]
はるか	faraway, remote
明瞭	clear, plain	[めいりょう]
バット	bat
叫び	shout, loud cry	[さけび]
一面	whole surface	[いちめん]
付録	appendix, supplement	[ふろく]
押さえる	hold down	[おさえる]
万年筆	fountain pen	[まんねんひつ]
固有	indigenousness, inherence	[こゆう]
ビデオテープ	videotape
取り扱う	handle, sell	[とりあつかう]
添える	add, attach	[そえる]
衰える	weaken, decline	[おとろえる]
手当て	treatment (of a wound or injury)	[てあて]
漏らす	give away, leak (something)	[もらす]
取り締まり	regulation, crackdown	[とりしまり]
頑固	stubborn, obstinate	[がんこ]
弁論	giving a speech, public speaking	[べんろん]
乱れる	be disordered, get messed up	[みだれる]
崖	cliff	[がけ]
見合い	meeting with one's potential spouse	[みあい]
小児科	pediatrics	[しょうにか]
墜落	fall, crash	[ついらく]
身の回り	everyday affair, one's association	[みのまわり]
交互	alternately	[こうご]
親善	goodwill, friendliness	[しんぜん]
晩年	one's later years	[ばんねん]
一帯	whole area, all over	[いったい]
放射能	radioactivity	[ほうしゃのう]
値引き	discount, price reduction	[ねびき]
元来	originally, by nature (formal)	[がんらい]
休める	give (body etc.) a rest	[やすめる]
渋い	mouth-puckering	[しぶい]
返却	return	[へんきゃく]
一部分	part, portion	[いちぶぶん]
戸籍	family register	[こせき]
大金	large amount of money	[たいきん]
弱る	weaken, be debilitated	[よわる]
無茶	recklessness, going beyond one's limit	[むちゃ]
無能	incompetent, incapable	[むのう]
憎しみ	hatred, grudge	[にくしみ]
当人	person in question	[とうにん]
滅びる	perish, die out	[ほろびる]
短大	junior college (for short)	[たんだい]
下痢	diarrhea	[げり]
忠告	advice, warning	[ちゅうこく]
夕暮れ	dusk, twilight	[ゆうぐれ]
模範	role model	[もはん]
人情	compassion, humanity	[にんじょう]
満月	full moon	[まんげつ]
割り当て	assignment, allotment	[わりあて]
新婚	newlywed	[しんこん]
動力	power, engine	[どうりょく]
にぎわう	bustle, be lively
軽蔑	contempt, despise	[けいべつ]
貴い	noble, invaluable	[とうとい]
売り出す	put (something) on sale	[うりだす]
インテリ	intelligent person
体格	physique, build	[たいかく]
侵す	infringe, violate	[おかす]
栄える	prosper, thrive	[さかえる]
結核	tuberculosis	[けっかく]
問屋	wholesale store, wholesaler	[とんや]
衣料	clothing material	[いりょう]
無邪気	innocent, ingenuous	[むじゃき]
学説	academic theory	[がくせつ]
勤勉	diligent, hard-working	[きんべん]
ろくに	hardly, barely
使い道	usage	[つかいみち]
沈没	sinking	[ちんぼつ]
有望	promising, hopeful	[ゆうぼう]
現像	developing a film	[げんぞう]
弾む	spring back, bounce	[はずむ]
軽快	light, cheerful	[けいかい]
内陸	inland	[ないりく]
滑らか	smooth, glassy	[なめらか]
沸騰	boiling	[ふっとう]
緩める	loosen (something) up	[ゆるめる]
不景気	recession, slump	[ふけいき]
窮屈	tight, cramped	[きゅうくつ]
生死	life and death	[せいし]
単調	monotonous, dull	[たんちょう]
印鑑	personal seal	[いんかん]
寝かせる	put someone to bed, lay down	[ねかせる]
真珠	pearl	[しんじゅ]
主食	staple food	[しゅしょく]
年長	seniority	[ねんちょう]
後回し	saving something for later, postponement	[あとまわし]
志す	aim, pursue	[こころざす]
偽物	imitation, fake	[にせもの]
股	crotch, groin	[また]
従業員	employee, worker	[じゅうぎょういん]
面する	face, look out on	[めんする]
植民地	colony	[しょくみんち]
整列	lining-up, forming a line	[せいれつ]
助詞	particle	[じょし]
和らげる	ease (something), relieve (a pain, etc.)	[やわらげる]
棄権	abstention, withdrawal (from a sport game etc.)	[きけん]
願書	application form	[がんしょ]
退学	dropping out of school	[たいがく]
便所	lavatory, bathroom	[べんじょ]
ズボン	trousers, pants
次男	second son	[じなん]
次女	second daughter	[じじょ]
カセットテープ	cassette tape
送り仮名	kana suffix	[おくりがな]
強める	strengthen (something)	[つよめる]
分裂	division, split	[ぶんれつ]
修了	completion (of a course of study)	[しゅうりょう]
のどか	tranquil, peaceful
近視	near-sightedness (formal)	[きんし]
待ち遠しい	can't wait for, long for	[まちどおしい]
慣れ	getting used to, habituation	[なれ]
早める	move forward (time, schedule etc.), expedite	[はやめる]
弱める	weaken (something)	[よわめる]
落ち着き	calm, composure	[おちつき]
油絵	oil painting	[あぶらえ]
手本	model, good example	[てほん]
改まる	be renewed, be improved	[あらたまる]
浜辺	beach, area around the seashore	[はまべ]
家出	running away from home	[いえで]
観衆	audience, spectators	[かんしゅう]
ジーパン	jeans
名札	name tag	[なふだ]
防火	fire prevention	[ぼうか]
産婦人科	obstetrics and gynecology department	[さんふじんか]
未婚	being unmarried, being single	[みこん]
過労	overwork	[かろう]
頑丈	solid, secure	[がんじょう]
値打ち	(subjective) value, worth	[ねうち]
使用人	servant	[しようにん]
生やす	grow (a beard, hair etc.)	[はやす]
効き目	effectiveness, efficacy	[ききめ]
勇敢	brave, heroic	[ゆうかん]
洋風	Western-like, Western-inspired	[ようふう]
待ち望む	look forward to, hope for	[まちのぞむ]
心掛ける	bear in mind	[こころがける]
聞き取り	listening comprehension	[ききとり]
同封	enclosure	[どうふう]
身なり	one's appearance, attire	[みなり]
水洗	flushing, washing	[すいせん]
鈍感	dull, insensitive	[どんかん]
ひび	crack
冷淡	cold-hearted, indifferent	[れいたん]
卑しい	greedy, vulgar	[いやしい]
さぞ	no doubt, must
休学	leave of absence from school	[きゅうがく]
始発	first departure	[しはつ]
平たい	flat and thin	[ひらたい]
封	seal, sealing	[ふう]
徐行	driving slowly	[じょこう]
天災	natural disaster	[てんさい]
生臭い	smelling fishy	[なまぐさい]
慣らす	accustom (oneself or someone) to	[ならす]
膨れる	expand, grow big	[ふくれる]
軽率	careless, thoughtless	[けいそつ]
私用	personal business	[しよう]
和やか	peaceful, friendly	[なごやか]
雨天	rainy weather	[うてん]
駆け足	gallop, run	[かけあし]
カンニング	cheating
年賀	New Year's celebration, New Year's gift	[ねんが]
見晴らし	view, outlook	[みはらし]
身振り	gesture	[みぶり]
指差す	point to	[ゆびさす]
襟	collar	[えり]
治まる	quiet down, subside	[おさまる]
恋する	have feelings (for), fall in love	[こいする]
裂ける	rip, tear	[さける]
沈める	sink (something)	[しずめる]
取り次ぐ	transfer a call	[とりつぐ]
顔つき	facial expression, countenance	[かおつき]
借り	debt, to owe someone something	[かり]
耳鼻科	otorhinology, ENT	[じびか]
成年	age of maturity, adulthood	[せいねん]
大概	mainly, mostly	[たいがい]
立て替える	pay for others (for the time being)	[たてかえる]
例え	example, metaphor	[たとえ]
冷やかす	tease, jeer	[ひやかす]
近眼	near-sightedness (colloquial)	[きんがん]
下調べ	preliminary research	[したしらべ]
姓名	full name	[せいめい]
手数	trouble, bother	[てすう]
遅らせる	delay (something)	[おくらせる]
かき回す	stir up	[かきまわす]
月謝	monthly fee	[げっしゃ]
度忘れ	slipping from one's memory	[どわすれ]
漏る	leak	[もる]
憧れ	yearning, longing	[あこがれ]
雨具	rainwear	[あまぐ]
臆病	cowardly, timid	[おくびょう]
微か	faint, dim	[かすか]
傷つく	get hurt	[きずつく]
群衆	masses (of people), crowd	[ぐんしゅう]
こたつ	table with an electric heater and a coverlet
沿う	live up to, go along	[そう]
たんぱく質	protein	[たんぱくしつ]
縮まる	be shortened, be contracted	[ちぢまる]
唾	spit, saliva	[つば]
眠たい	sleepy (casual)	[ねむたい]
ばかばかしい	silly, absurd
ひな祭り	the Doll Festival	[ひなまつり]
飛行場	airport, airdrome	[ひこうじょう]
ジェット機	jet airplane	[ジェットき]
田んぼ	rice field	[たんぼ]
ストーブ	stove
スチュワーデス	flight attendant
テープレコーダー	tape recorder
休校	temporary school closure	[きゅうこう]
取り締まる	control, crack down	[とりしまる]
緩む	come loose, be off-guard	[ゆるむ]
乱す	throw (something) into disorder, corrupt (something)	[みだす]
反感	antipathy	[はんかん]
真心	sincerity, true heart	[まごころ]
ミスプリント	misprint
寄りかかる	lean against something	[よりかかる]
もろい	brittle, fragile
親しみ	intimacy, familiarity	[したしみ]
そびえる	tower, rise high
虚しい	vain, (feel) empty	[むなしい]
割り込む	cut in	[わりこむ]
保護者	guardian, parent	[ほごしゃ]
生まれつき	by nature	[うまれつき]
受け身	being passive	[うけみ]
うちわ	round paper fan
主観的	subjective	[しゅかんてき]
建て前	one's public stance	[たてまえ]
よそ見	look away, take one's eyes off	[よそみ]
とじる	file, put something in (a folder, file etc.)
つぼみ	bud
ばい菌	bacterium, germ	[ばいきん]
控え室	waiting room	[ひかえしつ]
市場	marketplace (selling groceries)	[いちば]
交わる	cross, intersect	[まじわる]
埋める	bury, fill up (a hole, etc.)	[うめる]
目下	one's inferiors, subordinates	[めした]
末	last part, end	[まつ]
世論	public opinion	[よろん]
よる	be based on, depend on
もっとも	quite right
起こす	bring about, cause	[おこす]
挙げる	cite, give (an example)	[あげる]
大量	large mass or scale	[たいりょう]
金利	interest, interest rate	[きんり]
人権	human rights	[じんけん]
証券	securities	[しょうけん]
裁判所	courthouse	[さいばんしょ]
総理	prime minister of Japan (for short)	[そうり]
高齢	advanced age, old age	[こうれい]
戦後	postwar period	[せんご]
当局	authorities	[とうきょく]
自衛隊	Self Defense Forces	[じえいたい]
我が国	our country	[わがくに]
初期	initial period	[しょき]
キリスト教	Christianity	[キリストきょう]
翌日	the following day, the next day	[よくじつ]
府	(Osaka or Kyoto) prefecture	[ふ]
教員	teacher, faculty staff	[きょういん]
制御	control, command	[せいぎょ]
週刊	published weekly	[しゅうかん]
最適	optimum, best	[さいてき]
総裁	president, director-general	[そうさい]
変換	change, conversion	[へんかん]
朝日	morning sun	[あさひ]
市長	mayor	[しちょう]
入門	admission, introduction	[にゅうもん]
再開	reopening, resumption	[さいかい]
買収	acquisition, bribing	[ばいしゅう]
生き方	way of life	[いきかた]
長年	many years, long time	[ながねん]
外務省	Ministry of Foreign Affairs	[がいむしょう]
地上	above ground	[ちじょう]
反論	objection, counterargument	[はんろん]
原子力	atomic energy, nuclear power	[げんしりょく]
両者	both parties, both sides	[りょうしゃ]
仏教	Buddhism	[ぶっきょう]
不要	no need, unneeded	[ふよう]
疑い	doubt, suspicion	[うたがい]
少数	small number, minority	[しょうすう]
ひく	run over
奇跡	miracle	[きせき]
絵本	picture book	[えほん]
順位	order, rank	[じゅんい]
略	abbreviation	[りゃく]
前年	the year before	[ぜんねん]
求人	recruiting	[きゅうじん]
不安定	unstable	[ふあんてい]
出力	output	[しゅつりょく]
昨夜	last night, last evening (formal)	[さくや]
次第に	gradually	[しだいに]
小型	small size, compact size	[こがた]
出荷	shipping	[しゅっか]
グリーン	green (loan word)
死者	dead person	[ししゃ]
初日	first day, opening day	[しょにち]
不十分	insufficient	[ふじゅうぶん]
室内	indoors	[しつない]
率直	frank, openhearted	[そっちょく]
早朝	early morning	[そうちょう]
戦前	prewar period	[せんぜん]
利く	function, be effective	[きく]
最強	strongest	[さいきょう]
辞任	resignation	[じにん]
大国	world power, large country	[たいこく]
入国	entry into a country, immigration	[にゅうこく]
作り上げる	make up, build up	[つくりあげる]
国々	nations, countries	[くにぐに]
認可	approval, authorization	[にんか]
かつて	once, at one time in the past
たばこ屋	cigarette store	[たばこや]
不公平	unfair, unjust	[ふこうへい]
人手	staff, workforce	[ひとで]
野原	open field	[のはら]
欲求	(instinctive) desire, urge	[よっきゅう]
刑務所	prison	[けいむしょ]
気楽	easygoing, laid-back	[きらく]
入試	entrance examination	[にゅうし]
海上	on the sea, seaborne	[かいじょう]
エイズ	AIDS
有害	harmful, hazardous	[ゆうがい]
並み	ordinary, average	[なみ]
系列	affiliation	[けいれつ]
本年	this year (formal)	[ほんねん]
月刊	published monthly	[げっかん]
忠実	faithful, loyal	[ちゅうじつ]
陸上	shore, on land	[りくじょう]
一員	member, part of an organization, group, etc.	[いちいん]
無関係	irrelevant, unrelated	[むかんけい]
担任	teacher in charge	[たんにん]
開店	opening of a store	[かいてん]
戦場	battlefield	[せんじょう]
亀	turtle, tortoise	[かめ]
国旗	national flag	[こっき]
聞かす	let (someone) hear, tell (a story etc.)	[きかす]
関節	joint (of the body)	[かんせつ]
前期	previous term, last semester	[ぜんき]
最小	the smallest, minimum	[さいしょう]
気力	energy, vitality	[きりょく]
ラグビー	rugby
急増	sharp increase	[きゅうぞう]
言い換える	paraphrase, express in different words	[いいかえる]
罰金	fine, penalty	[ばっきん]
県立	prefectural	[けんりつ]
七夕	The Star Festival	[たなばた]
半導体	semiconductor	[はんどうたい]
間近	up close, close at hand	[まぢか]
偏る	be one-sided, be biased	[かたよる]
学長	school president, principal	[がくちょう]
最先端	cutting edge, forefront	[さいせんたん]
ありがたい	thankful, grateful
チキン	chicken
悪質	malignant, vicious	[あくしつ]
ジャーナリズム	journalism
敗れる	be defeated, lose (a game)	[やぶれる]
割り当てる	assign, allot	[わりあてる]
本店	main office, shop or store	[ほんてん]
市立	municipal, city-run	[しりつ]
会費	membership fee	[かいひ]
両面	both faces, both sides	[りょうめん]
国外	outside the country, abroad	[こくがい]
乗り出す	lean forward, embark on	[のりだす]
イスラム教	Islam, Muslim religion	[イスラムきょう]
打ち上げる	blast off, set off	[うちあげる]
法学部	faculty of law	[ほうがくぶ]
運動会	sports festival, athletic meet	[うんどうかい]
政治家	politician	[せいじか]
翌朝	the following morning, the next morning	[よくあさ]
不完全	imperfect, incomplete	[ふかんぜん]
地価	land price	[ちか]
理系	science, in science	[りけい]
歌声	singing voice	[うたごえ]
海水	seawater	[かいすい]
不愉快	upset, disagreeable	[ふゆかい]
総数	total (number)	[そうすう]
水中	in water, underwater	[すいちゅう]
帰省	homecoming, going (back) to one's hometown	[きせい]
年配	advanced age, elderliness	[ねんぱい]
一周	going round, circle	[いっしゅう]
歌舞伎	Japanese classical drama played by male actors	[かぶき]
悪用	abuse, misuse	[あくよう]
芋	potato (of any kind)	[いも]
空ける	vacate, clear out	[あける]
アルファベット	alphabet
菊	chrysanthemum	[きく]
平面	flat surface	[へいめん]
吸い込む	inhale, suck in	[すいこむ]
船長	captain	[せんちょう]
暴落	plunge, crash	[ぼうらく]
工学部	department of engineering	[こうがくぶ]
北東	northeast	[ほくとう]
高温	high temperature	[こうおん]
時給	hourly wage	[じきゅう]
派閥	clique, faction	[はばつ]
少量	small quantity, small amount	[しょうりょう]
不必要	unnecessary, unneeded	[ふひつよう]
火力	fire power	[かりょく]
非常識	lack of common sense	[ひじょうしき]
出国	departure (from a country)	[しゅっこく]
段落	paragraph	[だんらく]
種目	item, event	[しゅもく]
戦死	death in war	[せんし]
南西	southwest	[なんせい]
白紙	blank sheet of paper	[はくし]
発熱	heat generation, getting a fever	[はつねつ]
不平等	unequal, unfair	[ふびょうどう]
学費	tuition	[がくひ]
読み書き	reading and writing	[よみかき]
文系	liberal arts, humanities	[ぶんけい]
震度	seismic intensity	[しんど]
疑わしい	doubtful, suspicious	[うたがわしい]
夜空	night sky	[よぞら]
砂浜	sand beach	[すなはま]
多数	large number, a lot of	[たすう]
古本	secondhand book, used book	[ふるほん]
都立	Tokyo metropolitan	[とりつ]
初夏	early summer	[しょか]
銭湯	public bath, bathhouse	[せんとう]
病室	hospital room	[びょうしつ]
蜂	bee	[はち]
支社	branch office	[ししゃ]
多量	large quantity, large amount	[たりょう]
柿	persimmon	[かき]
反則	rule violation, foul	[はんそく]
のり	seaweed
冬季	winter season	[とうき]
無制限	unlimited	[むせいげん]
四方	all directions	[しほう]
不合格	failing an exam, failure	[ふごうかく]
水害	flood damage	[すいがい]
行程	distance, journey	[こうてい]
焼き鳥	skewered chicken	[やきとり]
南東	southeast	[なんとう]
年月日	year, month and date	[ねんがっぴ]
初恋	first love	[はつこい]
人名	person's name	[じんめい]
低温	low temperature	[ていおん]
小麦粉	flour	[こむぎこ]
同性	of the same sex	[どうせい]
旅費	travel expense	[りょひ]
小雨	drizzle	[こさめ]
長らく	for a long time	[ながらく]
洋画	foreign film	[ようが]
歴史的	historical	[れきしてき]
経済的	economical, economic	[けいざいてき]
論理的	logical, rational	[ろんりてき]
形式的	formal	[けいしきてき]
目的地	destination	[もくてきち]
目覚ましい	remarkable, marvelous	[めざましい]
散らばる	be scattered	[ちらばる]
ひとまず	for the time being, for a while
早まる	make a hasty decision, act rashly	[はやまる]
人出	turnout, crowd	[ひとで]
見物人	spectator, onlooker	[けんぶつにん]
雄大	grand, magnificent	[ゆうだい]
有毒	poisonous, toxic	[ゆうどく]
金もうけ	moneymaking	[かねもうけ]
追突	collision	[ついとつ]
惨め	miserable, pitiful	[みじめ]
弱気	wimpy, losing one's confidence	[よわき]
駅長	stationmaster	[えきちょう]
時機	right opportunity	[じき]
保証人	guarantor	[ほしょうにん]
物陰	shade, place to hide	[ものかげ]
急病	sudden illness	[きゅうびょう]
真っ最中	midst, to be in the middle of	[まっさいちゅう]
冷え込む	get cold	[ひえこむ]
禁酒	abstention from alcohol	[きんしゅ]
この度	this occasion	[このたび]
釣り合い	balance, proportion	[つりあい]
二流	second-rate, second-class	[にりゅう]
至る所	everywhere, all over	[いたるところ]
現住所	present address	[げんじゅうしょ]
逃げ道	escape route	[にげみち]
無害	harmless	[むがい]
衛生的	sanitary, hygienic	[えいせいてき]
作り話	fiction, made-up story	[つくりばなし]
握りしめる	grip, clench (one's hands)	[にぎりしめる]
早退	leaving earlier than usual	[そうたい]
筆記試験	written examination	[ひっきしけん]
風呂場	bathroom	[ふろば]
相づち	supportive reaction	[あいづち]
何て	what, how (colloquial)	[なんて]
ありのまま	as it is
知らず知らず	unknowingly, unconsciously	[しらずしらず]
順々に	by turns, one at a time	[じゅんじゅんに]
労働者	laborer, worker	[ろうどうしゃ]
科学者	scientist	[かがくしゃ]
ノーベル賞	Nobel Prize	[ノーベルしょう]
発電所	power plant	[はつでんしょ]
取り決め	decision, agreement	[とりきめ]
消火	fire extinction	[しょうか]
資本主義	capitalism	[しほんしゅぎ]
空き地	unoccupied land, vacant lot	[あきち]
北西	northwest	[ほくせい]
病死	death from sickness	[びょうし]
零下	below zero	[れいか]
セールスマン	sales representative, salesperson
日韓	Japan and (South) Korea	[にっかん]
運動場	playground, playing field	[うんどうじょう]
文化的	cultural	[ぶんかてき]
つるす	hang (something) with a string, etc.
共産主義	Communism	[きょうさんしゅぎ]
田畑	fields and rice paddies	[たはた]
低気圧	low pressure, atmospheric depression	[ていきあつ]
機長	(plane) captain	[きちょう]
夏季	summer season	[かき]
派出所	police box, police station	[はしゅつじょ]
落ち葉	fallen leaves	[おちば]
筋道	method, logic	[すじみち]
草花	plants and flowers	[くさばな]
狭まる	get narrow	[せばまる]
当初	initial, beginning	[とうしょ]
諸国	various countries	[しょこく]
梅雨明け	end of the rainy season	[つゆあけ]
入選	being selected for a contest, etc., being nominated	[にゅうせん]
狭める	narrow (something)	[せばめる]
話し言葉	spoken language	[はなしことば]
慣用句	idiom, common expression	[かんようく]
残暑	lingering summer heat	[ざんしょ]
隣り合う	adjoin, be next door to each other	[となりあう]
お年玉	New Year's gift money	[おとしだま]
訓読み	Japanese reading	[くんよみ]
都庁	Tokyo Metropolitan Government	[とちょう]
ごろごろ	rumble
飲み水	drinking water (colloquial)	[のみみず]
領事館	consulate	[りょうじかん]
事務員	clerical staff	[じむいん]
盆踊り	Bon dance festival	[ぼんおどり]
花婿	bridegroom	[はなむこ]
高気圧	high atmospheric pressure	[こうきあつ]
消火器	fire extinguisher	[しょうかき]
無色	colorless	[むしょく]
割り引く	give a discount, deduct	[わりびく]
音読み	Chinese-derived kanji reading	[おんよみ]
共通語	common language	[きょうつうご]
草木	plants and trees	[くさき]
木枯らし	cold wintry wind	[こがらし]
締まる	become tight, be firm	[しまる]
週休	weekly holiday	[しゅうきゅう]
見比べる	look and compare	[みくらべる]
剝げる	come off, peel off	[はげる]
要項	important points	[ようこう]
洋式	Western style	[ようしき]
怪しむ	suspect, doubt	[あやしむ]
参考書	reference book	[さんこうしょ]
出前	home delivery of food	[でまえ]
墓参り	visit to a grave	[はかまいり]
不幸せ	unhappy, unfortunate	[ふしあわせ]
歩行者天国	vehicle-free promenade	[ほこうしゃてんごく]
間に合わせる	make do	[まにあわせる]
例題	example problem	[れいだい]
胃腸	stomach and intestines	[いちょう]
行楽	outing, pleasure trip	[こうらく]
水力	water power, hydraulic power	[すいりょく]
似せる	imitate, model after	[にせる]
不得意	not good at, weak	[ふとくい]
和らぐ	soften, ease up	[やわらぐ]
イントネーション	intonation
観賞	ornamental	[かんしょう]
湿っぽい	damp, gloomy	[しめっぽい]
立て込む	be full of, be crowded with	[たてこむ]
父兄	parents, legal guardians	[ふけい]
街角	street corner	[まちかど]
割に	comparatively, rather	[わりに]
あぐら	sitting cross-legged
書き言葉	written language	[かきことば]
ガラス戸	glass door	[ガラスど]
既製	ready-made, ready-to-wear	[きせい]
気絶	fainting	[きぜつ]
歳末	year end	[さいまつ]
スモッグ	smog
全速力	full speed, full steam	[ぜんそくりょく]
たこ	octopus
地下道	underground passage	[ちかどう]
年始	beginning of the year	[ねんし]
のろい	slow, sluggish
ぴょんぴょん	jump, hop
貧乏人	poor person	[びんぼうにん]
月見	moon viewing	[つきみ]
とうもろこし	corn
引き伸ばす	stretch out, enlarge	[ひきのばす]
ひらひら	lightly fluttering, floating
町外れ	outskirts of town	[まちはずれ]
物知り	knowledgeable (wise) person	[ものしり]
後書き	afterword	[あとがき]
薄着	light clothing	[うすぎ]
がらがら	gargle
暑中見舞い	summer greeting	[しょちゅうみまい]
縦書き	vertical writing	[たてがき]
早寝	going to bed early	[はやね]
不確か	uncertain, unreliable	[ふたしか]
焼きそば	pan-fried noodles	[やきそば]
和式	Japanese style	[わしき]
学割	student discount	[がくわり]
厚着	heavy clothing	[あつぎ]
雨降り	rainfall, rainy weather	[あめふり]
書き取り	dictation, writing practice	[かきとり]
かちかち	hard, solid
男性的	masculine, manly	[だんせいてき]
月初め	the beginning of the month	[つきはじめ]
同姓	same surname	[どうせい]
長話	long conversation, long talk	[ながばなし]
肌色	flesh color, skin color	[はだいろ]
府庁	(Osaka or Kyoto) prefectural office	[ふちょう]
府立	prefectural (Osaka or Kyoto)	[ふりつ]
真四角	regular square (colloquial)	[ましかく]
小売店	retail store, outlet	[こうりてん]
悪女	wicked woman	[あくじょ]
荒らす	damage, ransack	[あらす]
洋室	Western-style room	[ようしつ]
旅客機	passenger plane	[りょかくき]
自国	one's own country	[じこく]
貨幣	money, currency	[かへい]
あらすじ	plot, storyline
言い表す	express in words	[いいあらわす]
いっぺんに	all at once, in a sweep
ウィークエンド	weekend (loan word)
裏表	inside-out, front and back	[うらおもて]
お歳暮	year-end gift	[おせいぼ]
がさがさ	rustle
がぶがぶ	guzzling, gulping
きれ	a cut of cloth
国名	country name	[こくめい]
時間割り	time schedule, timetable	[じかんわり]
じゃぶじゃぶ	splashing, washing
秋分	autumnal equinox	[しゅうぶん]
春夏秋冬	four seasons	[しゅんかしゅうとう]
春分	vernal equinox	[しゅんぶん]
女性的	feminine, womanly	[じょせいてき]
師走	December	[しわす]
ちょうちょう	butterfly
月夜	moonlit night	[つきよ]
漬物	pickle, pickled vegetable	[つけもの]
包み紙	wrapping paper	[つつみがみ]
つばめ	swallow
梅雨入り	start of the rainy season	[つゆいり]
鶴	crane	[つる]
寝転ぶ	lie down	[ねころぶ]
泣き顔	crying face	[なきがお]
はえ	fly (bug)
はかり	scale
腹いっぱい	full stomach	[はらいっぱい]
町なか	in the town	[まちなか]
まねる	imitate, mimic
明朝	tomorrow morning	[みょうちょう]
もうけ	profit
よす	quit, stop
悪賢い	cunning, sly	[わるがしこい]
お中元	mid-year gift, summer gift	[おちゅうげん]
きらりと	sparklingly, glittering
ごくんと	in one gulp
ぴょんと	(jump or hop) lightly
ひらりと	in a fluttering motion
もうじき	soon
市外	outside the city	[しがい]
喜ばす	please, make (someone) happy	[よろこばす]
小川	stream, brook	[おがわ]
知れる	become known, be found out	[しれる]
一向に	absolutely (not) (formal, mainly in written)	[いっこうに]
しきりに	repeatedly, constantly
代わる代わる	by turns, in turn	[かわるがわる]
木の葉	tree leaves	[このは]
寄り集まる	gather, get together	[よりあつまる]
何べん	(how) many times	[なんべん]
日	Japan	[にち]
上	people in authority, government	[かみ]
氏	Mr., Mrs., pronoun for the third person	[し]
間	interval, time (in between)	[ま]
名	name, reputation	[な]
位	rank, dignity	[くらい]
局	bureau, station	[きょく]
小	small version, small size	[しょう]
額	picture frame	[がく]
皆	all, everybody	[みな]
王	king (plain)	[おう]
連れる	take along, bring along	[つれる]
辛い	harsh, severe	[からい]
注	annotation, explanatory note	[ちゅう]
正	original (copy)	[せい]
弾	bullet	[たま]
原	plain, field	[はら]
一種	a type of, a kind of	[いっしゅ]
田	rice field, rice paddy	[た]
仏	Buddha, Buddhist image	[ほとけ]
球	globe, ball	[きゅう]
農民	peasant, farmer	[のうみん]
郡	county	[ぐん]
古典	classics	[こてん]
上下	top and bottom (Japanese origin)	[うえした]
能	the Noh play	[のう]
句	phrase	[く]
武士	Samurai warrior	[ぶし]
兵隊	soldier, troops	[へいたい]
俳句	Japanese seventeen-syllabled verse	[はいく]
祝い	celebration, congratulation	[いわい]
月日	month and date	[がっぴ]
英和	English-Japanese	[えいわ]
下宿	lodging, boarding house	[げしゅく]
訓	Japanese reading of kanji	[くん]
ピストル	pistol
ママ	mom
パパ	dad
ペンチ	pliers, pincers
漢和	Chinese and Japanese	[かんわ]
字引	dictionary, encyclopedia	[じびき]
はんこ	seal, stamp
頭	head (of a group), chief	[かしら]
音	comfortable sound	[ね]
設定	setting	[せってい]
検索	search	[けんさく]
投稿	posting, sending (an article etc.)	[とうこう]
指示	instruction, direction	[しじ]
シェフ	chef
盆	the Bon festival	[ぼん]
陸	land, ground	[おか]
策	scheme, plan	[さく]
小便	urine, pee	[しょうべん]
坊さん	Buddhist priest	[ぼうさん]
世論	popular sentiment	[せろん]
柄	handle, grip	[え]
管	pipe, tube	[かん]
調べ	investigation, search	[しらべ]
露	dew, dewfall	[つゆ]
合唱	chorus	[がっしょう]
獣	beast	[けもの]
札	bill, paper money (colloquial)	[さつ]
液	liquid, fluid	[えき]
外相	Minister of Foreign Affairs	[がいしょう]
尾	tail	[お]
浜	beach, seashore	[はま]
幹	tree trunk	[みき]
無論	needless to say	[むろん]
水田	paddy field, rice paddy	[すいでん]
本国	one's native country, home country	[ほんごく]
区画	division, section	[くかく]
海峡	straits, channel	[かいきょう]
喜劇	comedy	[きげき]
茎	stem	[くき]
山脈	mountain range	[さんみゃく]
旅客	traveler, passenger	[りょかく]
群集	crowd, mass	[ぐんしゅう]
ぞんざい	rough, rude
準急	local express	[じゅんきゅう]
平方	square (measure)	[へいほう]
結び	end, close	[むすび]
海流	ocean current	[かいりゅう]
殊に	especially	[ことに]
織物	textile, woven fabric	[おりもの]
合わす	match, combine	[あわす]
漢語	words of Chinese origin	[かんご]
大便	stool, feces	[だいべん]
打ち消す	negate, deny	[うちけす]
大水	flood	[おおみず]
目方	weight (old expression)	[めかた]
仲人	go-between, matchmaker	[なこうど]
札	sign, tag	[ふだ]
上がる	be completed, be finished (literary)	[あがる]
明治	Meiji era	[めいじ]
有限	limited, finite	[ゆうげん]
学園	educational institution, school	[がくえん]
マネー	money (loan word)
使い	errand	[つかい]
大正	Taisho era	[たいしょう]
航空機	aircraft, airplane	[こうくうき]
木造	being made of wood, wooden (things)	[もくぞう]
ガード	guardrail
麦	wheat and/or barley	[むぎ]
上流	upstream	[じょうりゅう]
神道	Shinto	[しんとう]
下流	downstream	[かりゅう]
囲碁	"go" (game)	[いご]
払い	payment, bill (to pay)	[はらい]
聞き手	listener, audience	[ききて]
河口	river mouth, estuary	[かこう]
裏門	back gate	[うらもん]
私費	private expense	[しひ]
国費	national expenditure, government expense	[こくひ]
秋風	autumn breeze	[あきかぜ]
履物	footwear	[はきもの]
朝顔	morning glory	[あさがお]
からから	(laugh) loudly
西洋人	Westerner	[せいようじん]
天の川	Milky Way	[あまのがわ]
中流	mid-stream, middle reaches	[ちゅうりゅう]
洋間	Western-style room	[ようま]
短期大学	junior college	[たんきだいがく]
開き	opening	[あき]
無生物	inanimate object	[むせいぶつ]
アルミニウム	aluminum
外来語	loanword, foreign word	[がいらいご]
百科事典	encyclopedia	[ひゃっかじてん]
和語	native Japanese word	[わご]
ちり	very small piece of dust, specks
寒暖計	thermometer	[かんだんけい]
縮み	shrinkage	[ちぢみ]
暖か	warm	[あたたか]
乞食	beggar	[こじき]
最上	best, highest	[さいじょう]
酒屋	liquor store	[さかや]
大麦	barley	[おおむぎ]
間	interval, meantime	[かん]
博士	Ph.D.	[はくし]
大蔵省	Ministry of Finance	[おおくらしょう]
国鉄	Japan National Railways	[こくてつ]
日ソ	Japanese-Soviet	[にっソ]
ディスコ	disco
録音テープ	recording tape	[ろくおんテープ]
パンティー	underwear
ばあさん	grandmother, old lady
文学者	literary person, literati	[ぶんがくしゃ]
用例	illustrative example, usage example	[ようれい]
引き延ばす	extend, prolong	[ひきのばす]
ぺらぺら	flimsy, thin
